,"Valores processados, HM, milhares de euros","Valores processados, H, milhares de euros","Valores processados, M, milhares de euros","Dias processados, HM, N.º","Dias processados, H, N.º","Dias processados, M, N.º"
Portugal,1315485,603306,712179,73265637,31135651,42129986
Continente,1257776,574226,683550,69766540,29421183,40345357
Norte,450100,201639,248462,25713752,10550431,15163321
Alto Minho,20065,9064,11001,1157166,480576,676590
Arcos de Valdevez,1320,545,775,80517,31788,48729
Caminha,1480,654,827,86138,35472,50666
Melgaço,222,92,130,12602,4878,7724
Monção,1128,417,711,68424,23663,44761
Paredes de Coura,926,415,512,54867,23199,31668
Ponte da Barca,700,319,381,42838,18149,24689
Ponte de Lima,3254,1317,1937,197277,74642,122635
Valença,1559,656,903,94785,38783,56002
Viana do Castelo,8511,4239,4272,462886,207000,255886
Vila Nova de Cerveira,963,410,553,56832,23002,33830
Cávado,43172,18111,25061,2443499,940338,1503161
Amares,1702,712,990,98066,36795,61271
Barcelos,10912,4722,6191,624159,244587,379572
Braga,23156,9584,13572,1287686,492877,794809
Esposende,3012,1277,1735,169163,66339,102824
Terras de Bouro,660,320,340,44220,19614,24606
Vila Verde,3730,1495,2234,220205,80126,140079
Ave,58862,24299,34563,3436332,1299918,2136414
Cabeceiras de Basto,1356,603,754,81398,33400,47998
Fafe,7245,2771,4474,442250,158193,284057
Guimarães,24614,10084,14529,1445686,554543,891143
Mondim de Basto,369,197,173,23250,12183,11067
Póvoa de Lanhoso,2392,1141,1251,137079,57433,79646
Vieira do Minho,1281,655,625,76278,33826,42452
Vila Nova de Famalicão,17694,7324,10371,995857,366004,629853
Vizela,3911,1525,2386,234534,84336,150198
A. M. Porto,251070,117320,133750,14048946,6038544,8010402
Arouca,1578,692,887,94043,36285,57758
Espinho,3824,1921,1903,208829,95149,113680
Gondomar,23429,11222,12207,1350850,599759,751091
Maia,19938,9208,10730,1058311,446594,611717
Matosinhos,27682,13959,13723,1481720,690118,791602
Oliveira de Azeméis,8580,3585,4995,501314,189614,311700
Paredes,10214,4168,6046,629527,231723,397804
Porto,34770,17433,17337,1881233,899566,981667
Póvoa de Varzim,8232,3862,4370,470249,199413,270836
Santa Maria da Feira,18242,8111,10130,1043329,424940,618389
Santo Tirso,9548,3840,5708,559256,204725,354531
São João da Madeira,4000,1792,2208,234720,99125,135595
Trofa,5950,2199,3751,347941,112854,235087
Vale de Cambra,1572,594,978,90349,29276,61073
Valongo,13396,6098,7297,754294,311718,442576
Vila do Conde,11576,5245,6331,652615,261940,390675
Vila Nova de Gaia,48540,23390,25149,2690366,1205745,1484621
Alto Tâmega,5699,2785,2914,333760,149384,184376
Boticas,297,133,164,17634,7416,10218
Chaves,2772,1235,1537,167349,69207,98142
Montalegre,420,255,164,22086,12713,9373
Ribeira de Pena,569,325,244,31893,16393,15500
Valpaços,702,312,390,43471,18689,24782
Vila Pouca de Aguiar,939,525,414,51327,24966,26361
Tâmega e Sousa,49278,19258,30020,2996372,1047369,1949003
Amarante,6348,2188,4161,379895,117022,262873
Baião,1778,828,950,104729,42988,61741
Castelo de Paiva,1551,717,834,91784,36761,55023
Celorico de Basto,1582,700,881,95644,37655,57989
Cinfães,1917,1006,911,111611,53281,58330
Felgueiras,9522,3804,5718,583015,217585,365430
Lousada,5864,2020,3844,364253,112090,252163
Marco de Canaveses,5811,2277,3534,347225,112578,234647
Paços de Ferreira,6185,2444,3741,381323,139362,241961
Penafiel,8006,2895,5111,491380,155495,335885
Resende,714,379,336,45513,22552,22961
Douro,14990,7448,7542,881386,408590,472796
Alijó,768,435,333,45167,23423,21744
Armamar,442,174,267,25897,9674,16223
Carrazeda de Ansiães,313,124,189,20087,6664,13423
Freixo de Espada à Cinta,121,37,85,7672,2081,5591
Lamego,2800,1554,1246,158142,81743,76399
Mesão Frio,268,132,135,16274,7421,8853
Moimenta da Beira,726,360,366,43298,20410,22888
Murça,359,205,155,20269,10194,10075
Penedono,130,68,63,7597,3279,4318
Peso da Régua,1268,574,694,78587,33737,44850
Sabrosa,436,142,294,27317,7832,19485
Santa Marta de Penaguião,456,261,196,28328,15609,12719
São João da Pesqueira,376,174,201,22581,9326,13255
Sernancelhe,229,100,129,14630,5760,8870
Tabuaço,362,193,169,22499,11157,11342
Tarouca,681,369,312,37273,19298,17975
Torre de Moncorvo,562,260,302,34549,14879,19670
Vila Nova de Foz Côa,448,228,221,26171,12524,13647
Vila Real,4244,2058,2185,245048,113579,131469
Terras de Trás-os-Montes,6964,3353,3611,416291,185712,230579
Alfândega da Fé,369,225,145,20560,11701,8859
Bragança,2259,1087,1172,135614,61413,74201
Macedo de Cavaleiros,823,407,417,47486,21516,25970
Miranda do Douro,281,106,175,17507,6014,11493
Mirandela,1785,800,985,107393,43552,63841
Mogadouro,463,240,223,28572,13826,14746
Vila Flor,478,277,201,27850,14715,13135
Vimioso,146,43,103,8511,2637,5874
Vinhais,360,169,191,22798,10338,12460
Centro,209692,92630,117062,11760649,4694172,7066477
Oeste,41163,17532,23631,2283893,866350,1417543
Alcobaça,4790,1914,2876,269597,95479,174118
Alenquer,6759,2969,3790,369157,146513,222644
Arruda dos Vinhos,1645,806,839,80810,35258,45552
Bombarral,1375,629,746,78836,30443,48393
Cadaval,1538,512,1026,88148,25451,62697
Caldas da Rainha,6035,2459,3577,337099,122481,214618
Lourinhã,2535,1057,1478,143468,51285,92183
Nazaré,1946,794,1152,114743,42773,71970
Óbidos,1189,482,707,68436,24630,43806
Peniche,4168,1862,2306,237607,92712,144895
Sobral de Monte Agraço,904,417,487,48080,19089,28991
Torres Vedras,8279,3632,4646,447912,180236,267676
Região de Aveiro,36111,16569,19542,1957201,800433,1156768
Águeda,4051,1550,2501,227017,80039,146978
Albergaria-a-Velha,2242,1028,1214,120579,48917,71662
Anadia,2176,930,1246,118718,46987,71731
Aveiro,8481,4089,4391,441884,190889,250995
Estarreja,2480,1261,1219,129669,55829,73840
Ílhavo,4374,2122,2252,234953,99352,135601
Murtosa,1023,593,430,52900,26645,26255
Oliveira do Bairro,1772,701,1072,98199,35657,62542
Ovar,7081,3303,3778,396214,166496,229718
Sever do Vouga,674,326,348,35519,15426,20093
Vagos,1757,667,1090,101549,34196,67353
Região de Coimbra,38858,18507,20351,2152151,936374,1215777
Arganil,745,325,421,43589,17164,26425
Cantanhede,2675,1194,1481,153630,61411,92219
Coimbra,13506,6770,6736,720644,336861,383783
Condeixa-a-Nova,1399,588,811,76106,28653,47453
Figueira da Foz,6952,3659,3293,370967,174635,196332
Góis,247,118,129,14647,6305,8342
Lousã,1299,559,740,77398,29779,47619
Mealhada,1884,841,1043,103392,41544,61848
Mira,966,416,550,57846,23868,33978
Miranda do Corvo,826,348,478,48643,18599,30044
Montemor-o-Velho,2197,855,1342,122564,42608,79956
Mortágua,472,211,261,28977,12003,16974
Oliveira do Hospital,1771,897,874,105125,49746,55379
Pampilhosa da Serra,168,99,69,10300,6117,4183
Penacova,737,326,411,42936,17176,25760
Penela,229,103,126,13433,5402,8031
Soure,1333,598,734,73649,30317,43332
Tábua,834,329,505,52422,19840,32582
Vila Nova de Poiares,620,271,349,35883,14346,21537
Região de Leiria,25950,10689,15261,1429015,520642,908373
Alvaiázere,236,95,141,14467,5618,8849
Ansião,741,263,478,44262,14965,29297
Batalha,1412,534,877,76667,25664,51003
Castanheira de Pêra,182,72,110,11348,3877,7471
Figueiró dos Vinhos,359,186,173,21735,10187,11548
Leiria,11914,4819,7096,649946,230078,419868
Marinha Grande,5657,2514,3143,299133,115544,183589
Pedrógão Grande,258,139,119,15816,8247,7569
Pombal,3240,1261,1979,184077,65338,118739
Porto de Mós,1951,806,1144,111564,41124,70440
Viseu Dão Lafões,25024,10641,14382,1456000,565724,890276
Aguiar da Beira,406,205,202,22826,11267,11559
Carregal do Sal,783,276,507,47435,14577,32858
Castro Daire,1332,700,633,76537,36002,40535
Mangualde,2121,813,1307,127808,43698,84110
Nelas,1428,671,757,82086,33706,48380
Oliveira de Frades,1167,482,685,68873,26665,42208
Penalva do Castelo,817,299,518,48318,16030,32288
Santa Comba Dão,1021,489,532,56952,23682,33270
São Pedro do Sul,1546,655,890,97017,37675,59342
Sátão,943,387,556,57965,22308,35657
Tondela,2442,911,1531,137251,46323,90928
Vila Nova de Paiva,426,242,184,25201,14003,11198
Viseu,9276,4114,5162,531317,218992,312325
Vouzela,1316,398,918,76414,20796,55618
Beira Baixa,6707,2941,3766,395782,158299,237483
Castelo Branco,4909,2137,2772,286505,112644,173861
Idanha-a-Nova,620,291,329,37831,17181,20650
Oleiros,142,73,69,8874,4458,4416
Penamacor,326,112,215,21080,6757,14323
Proença-a-Nova,468,251,217,26835,12778,14057
Vila Velha de Ródão,243,77,166,14657,4481,10176
Médio Tejo,18654,8325,10330,1067307,438009,629298
Abrantes,3992,2074,1917,228840,109879,118961
Alcanena,1177,540,637,69170,30113,39057
Constância,323,166,157,17030,7834,9196
Entroncamento,1770,721,1050,101666,36877,64789
Ferreira do Zêzere,305,114,191,18169,6733,11436
Mação,357,206,151,21475,12100,9375
Ourém,3294,1096,2198,183720,54768,128952
Sardoal,396,180,216,23228,9802,13426
Sertã,737,266,471,42087,13765,28322
Tomar,2743,1360,1383,159623,73450,86173
Torres Novas,2909,1286,1623,163402,65735,97667
Vila de Rei,228,123,105,13901,7070,6831
Vila Nova da Barquinha,423,193,231,24996,9883,15113
Beiras e Serra da Estrela,17224,7425,9799,1019300,408341,610959
Almeida,385,151,234,22763,7815,14948
Belmonte,778,287,491,48107,15709,32398
Celorico da Beira,616,309,307,34871,16320,18551
Covilhã,4744,2082,2662,287692,118398,169294
Figueira de Castelo Rodrigo,271,108,162,18188,6959,11229
Fornos de Algodres,262,87,175,16574,5138,11436
Fundão,2182,844,1338,128710,45187,83523
Gouveia,838,385,453,43727,18979,24748
Guarda,3781,1603,2178,219375,86399,132976
Manteigas,258,136,122,15492,7793,7699
Mêda,184,102,83,11345,6036,5309
Pinhel,479,232,248,27776,12347,15429
Sabugal,662,269,393,38636,14104,24532
Seia,1446,690,756,85239,39069,46170
Trancoso,339,141,197,20805,8088,12717
A. M. Lisboa,429390,203363,226027,22404534,9964462,12440072
Alcochete,2754,1393,1361,136704,63466,73238
Almada,26098,12202,13896,1394797,607467,787330
Amadora,25280,11572,13709,1385947,599693,786254
Barreiro,12502,6172,6330,672363,308491,363872
Cascais,31454,14508,16946,1529427,672015,857412
Lisboa,80709,41148,39561,4053148,2038808,2014340
Loures,31115,14508,16607,1666659,724201,942458
Mafra,9803,4560,5243,487314,207118,280196
Moita,10928,5357,5571,599918,262846,337072
Montijo,8427,4090,4338,454014,205720,248294
Odivelas,21163,10031,11133,1157027,519064,637963
Oeiras,24992,11695,13296,1165499,513058,652441
Palmela,10485,4820,5666,544880,224678,320202
Seixal,23851,10882,12969,1279433,539475,739958
Sesimbra,7428,3593,3835,385962,164805,221157
Setúbal,20161,10300,9861,1061748,492909,568839
Sintra,59974,25923,34051,3274833,1317865,1956968
Vila Franca de Xira,22265,10611,11654,1154861,502783,652078
Alentejo,78281,36809,41472,4490999,1936049,2554950
Alentejo Litoral,14146,8035,6110,787062,409405,377657
Alcácer do Sal,959,396,563,55820,20610,35210
Grândola,1045,480,565,59121,24045,35076
Odemira,5542,3183,2359,334617,187200,147417
Santiago do Cacém,3701,2119,1582,193511,97768,95743
Sines,2899,1857,1042,143993,79782,64211
Baixo Alentejo,11717,5649,6068,695036,312367,382669
Aljustrel,862,365,497,50526,19035,31491
Almodôvar,774,408,365,41858,19261,22597
Alvito,161,98,63,9265,5022,4243
Barrancos,178,86,92,11513,5602,5911
Beja,2967,1470,1498,173587,81314,92273
Castro Verde,775,363,412,41243,17392,23851
Cuba,332,137,195,20192,7743,12449
Ferreira do Alentejo,844,354,491,51372,20354,31018
Mértola,584,309,275,34972,17468,17504
Moura,1414,728,686,88200,42433,45767
Ourique,656,335,321,38865,18155,20710
Serpa,1549,693,856,95728,40930,54798
Vidigueira,621,304,318,37715,17658,20057
Lezíria do Tejo,27248,12260,14988,1539948,628049,911899
Almeirim,2695,1055,1640,159345,57671,101674
Alpiarça,895,384,511,51157,19558,31599
Azambuja,2879,1360,1518,159801,68142,91659
Benavente,4264,1954,2310,232674,96342,136332
Cartaxo,3174,1660,1515,169474,80959,88515
Chamusca,777,289,488,48595,16795,31800
Coruche,1815,688,1127,109770,37200,72570
Golegã,414,178,235,23932,9470,14462
Rio Maior,1749,637,1112,102862,34578,68284
Salvaterra de Magos,3188,1357,1831,181679,68161,113518
Santarém,5399,2698,2701,300659,139173,161486
Alto Alentejo,10736,4689,6047,645227,266374,378853
Alter do Chão,324,164,160,19421,9478,9943
Arronches,176,76,101,10493,4603,5890
Avis,437,134,303,27734,7652,20082
Campo Maior,1149,557,593,64788,29776,35012
Castelo de Vide,234,112,123,13364,6387,6977
Crato,246,96,150,15239,5747,9492
Elvas,2347,998,1349,138900,55959,82941
Fronteira,345,139,205,21016,7782,13234
Gavião,271,150,121,15205,7988,7217
Marvão,216,112,103,13313,6676,6637
Monforte,196,91,106,12755,5540,7215
Nisa,432,210,222,26934,12897,14037
Ponte de Sor,1772,759,1013,109126,42815,66311
Portalegre,2069,902,1167,123362,51966,71396
Sousel,521,189,332,33577,11108,22469
Alentejo Central,14434,6176,8259,823726,319854,503872
Alandroal,407,169,238,24681,8873,15808
Arraiolos,545,227,317,31066,11927,19139
Borba,579,205,374,36666,11667,24999
Estremoz,875,404,470,49547,21098,28449
Évora,5727,2628,3099,312807,131469,181338
Montemor-o-Novo,1041,470,571,58167,24021,34146
Mora,318,114,204,18711,5988,12723
Mourão,305,146,159,18554,8776,9778
Portel,767,291,476,47577,16467,31110
Redondo,626,199,427,38504,11986,26518
Reguengos de Monsaraz,1311,539,772,76700,27797,48903
Vendas Novas,925,397,527,51399,19617,31782
Viana do Alentejo,461,182,279,28147,10085,18062
Vila Viçosa,548,203,345,31200,10083,21117
Algarve,90313,39785,50527,5396606,2276069,3120537
Albufeira,17017,7762,9254,1035364,457382,577982
Alcoutim,133,69,65,7157,3167,3990
Aljezur,588,274,314,37167,16929,20238
Castro Marim,887,445,442,54279,25584,28695
Faro,10409,4806,5603,587598,258834,328764
Lagoa,4845,2063,2782,295389,122476,172913
Lagos,5770,2450,3321,352914,143747,209167
Loulé,14680,6420,8260,853739,358297,495442
Monchique,492,193,300,31346,11761,19585
Olhão,5644,2366,3278,334267,130528,203739
Portimão,13413,5959,7454,817492,344373,473119
São Brás de Alportel,1262,515,747,68446,26913,41533
Silves,7644,3237,4407,457029,186402,270627
Tavira,3309,1400,1909,201565,81374,120191
Vila do Bispo,988,441,548,59899,25853,34046
Vila Real de Santo António,3231,1386,1845,202955,82449,120506
R. A. Açores,23284,11897,11387,1437915,723850,714065
Santa Maria,561,243,319,36570,15421,21149
Vila do Porto,561,243,319,36570,15421,21149
São Miguel,13972,7257,6715,868060,448188,419872
Lagoa (R.A.A.),1532,880,651,96590,55426,41164
Nordeste,840,435,405,57720,30249,27471
Ponta Delgada,6121,3024,3097,359337,175815,183522
Povoação,1035,520,515,71657,35978,35679
Ribeira Grande,3286,1812,1474,210993,115149,95844
Vila Franca do Campo,1158,586,572,71763,35571,36192
Terceira,4555,2415,2140,266515,135462,131053
Angra do Heroísmo,3084,1660,1424,179051,93459,85592
Vila da Praia da Vitória,1471,756,715,87464,42003,45461
Graciosa,440,198,242,30294,13530,16764
Santa Cruz da Graciosa,440,198,242,30294,13530,16764
São Jorge,723,405,318,47280,26559,20721
Calheta (R.A.A.),223,141,82,14684,9364,5320
Velas,500,264,236,32596,17195,15401
Pico,1326,555,771,83489,34368,49121
Lajes do Pico,462,205,256,30336,13146,17190
Madalena,566,228,338,34556,13159,21397
São Roque do Pico,298,122,176,18597,8063,10534
Faial,1275,667,608,76552,39123,37429
Horta,1275,667,608,76552,39123,37429
Flores,390,141,250,26297,10167,16130
Lajes das Flores,177,60,116,12472,4450,8022
Santa Cruz das Flores,214,81,133,13825,5717,8108
Corvo,41,15,26,2858,1032,1826
Corvo,41,15,26,2858,1032,1826
R. A. Madeira,33217,16366,16850,2005960,957075,1048885
Calheta (R.A.M.),946,443,503,59089,27086,32003
Câmara de Lobos,4133,1995,2138,258310,120141,138169
Funchal,14935,7342,7593,886573,423529,463044
Machico,2833,1538,1295,171534,88240,83294
Ponta do Sol,663,281,382,43303,18176,25127
Porto Moniz,330,132,198,20875,8474,12401
Ribeira Brava,1437,672,765,91505,41649,49856
Santa Cruz,6050,2959,3091,350477,165517,184960
Santana,517,303,214,35366,20184,15182
São Vicente,328,168,160,23009,11914,11095
Porto Santo,1045,532,513,65919,32165,33754
