,"Total, N.º","Sexo, H, N.º","Sexo, M, N.º","Idade, Menos de 25 anos, N.º","Idade, 25-39 anos, N.º","Idade, 40-54 anos, N.º","Idade, 55 e mais anos, N.º","Valores processados, 55 e mais anos, milhares de euros"
Portugal,262206,125908,136298,108156,42252,56292,55506,324260
Continente,237164,113494,123670,97148,37348,50978,51690,297505
Norte,93464,44410,49054,34299,13845,21550,23770,118869
Alto Minho,2725,1412,1313,864,363,582,916,3588
Arcos de Valdevez,197,105,92,29,21,39,108,266
Caminha,178,105,73,40,21,40,77,246
Melgaço,63,37,26,6,3,17,37,83
Monção,151,79,72,28,6,37,80,199
Paredes de Coura,68,39,29,6,4,10,48,91
Ponte da Barca,84,42,42,12,8,18,46,105
Ponte de Lima,323,147,176,69,23,86,145,411
Valença,304,156,148,121,43,60,80,403
Viana do Castelo,1273,650,623,537,226,249,261,1669
Vila Nova de Cerveira,84,52,32,16,8,26,34,114
Cávado,3455,1712,1743,1296,489,777,893,4173
Amares,206,102,104,82,28,41,55,229
Barcelos,480,249,231,164,53,101,162,612
Braga,2273,1124,1149,878,346,533,516,2761
Esposende,137,56,81,32,14,33,58,173
Terras de Bouro,66,43,23,18,5,20,23,60
Vila Verde,293,138,155,122,43,49,79,338
Ave,4536,2301,2235,1621,576,1069,1270,5644
Cabeceiras de Basto,351,171,180,120,24,97,110,401
Fafe,567,275,292,208,90,120,149,715
Guimarães,1281,680,601,455,158,312,356,1576
Mondim de Basto,203,104,99,62,22,46,73,212
Póvoa de Lanhoso,237,115,122,57,26,65,89,303
Vieira do Minho,242,127,115,63,17,70,92,332
Vila Nova de Famalicão,1538,758,780,629,228,333,348,1966
Vizela,117,71,46,27,11,26,53,139
A. M. Porto,59317,27771,31546,22331,9029,13647,14310,76377
Arouca,222,105,117,49,18,53,102,291
Espinho,1005,457,548,366,149,226,264,1264
Gondomar,6350,2959,3391,2507,1009,1470,1364,7662
Maia,3695,1653,2042,1454,537,801,903,4749
Matosinhos,5925,2685,3240,2265,929,1266,1465,7539
Oliveira de Azeméis,532,257,275,167,59,133,173,685
Paredes,2372,1123,1249,835,306,565,666,3025
Porto,15145,7318,7827,5720,2516,3480,3429,20319
Póvoa de Varzim,1241,608,633,398,174,298,371,1664
Santa Maria da Feira,2226,1066,1160,745,289,568,624,2956
Santo Tirso,1279,632,647,458,181,287,353,1743
São João da Madeira,365,162,203,133,60,80,92,439
Trofa,599,249,350,226,69,144,160,671
Vale de Cambra,159,66,93,28,12,39,80,249
Valongo,3492,1556,1936,1374,488,813,817,4418
Vila do Conde,1064,569,495,404,184,221,255,1316
Vila Nova de Gaia,13646,6306,7340,5202,2049,3203,3192,17383
Alto Tâmega,2585,1392,1193,771,327,603,884,3341
Boticas,88,50,38,17,6,25,40,128
Chaves,1165,614,551,402,178,259,326,1633
Montalegre,205,122,83,50,17,44,94,251
Ribeira de Pena,226,121,105,50,22,49,105,248
Valpaços,528,279,249,148,63,131,186,659
Vila Pouca de Aguiar,373,206,167,104,41,95,133,423
Tâmega e Sousa,11611,5096,6515,4151,1522,2772,3166,13976
Amarante,1796,741,1055,645,243,439,469,2202
Baião,772,317,455,283,96,191,202,799
Castelo de Paiva,282,128,154,97,26,74,85,331
Celorico de Basto,456,223,233,119,36,107,194,593
Cinfães,716,314,402,205,89,185,237,980
Felgueiras,942,446,496,343,119,238,242,1171
Lousada,905,414,491,342,121,207,235,987
Marco de Canaveses,1953,777,1176,723,264,478,488,2498
Paços de Ferreira,1436,697,739,527,208,312,389,1683
Penafiel,1836,785,1051,693,236,407,500,2170
Resende,517,254,263,174,84,134,125,562
Douro,6669,3375,3294,2245,1084,1543,1797,8628
Alijó,364,206,158,88,54,95,127,505
Armamar,171,90,81,49,24,40,58,205
Carrazeda de Ansiães,119,66,53,52,23,21,23,134
Freixo de Espada à Cinta,141,71,70,59,35,35,12,195
Lamego,761,372,389,247,106,180,228,1065
Mesão Frio,178,74,104,50,22,42,64,230
Moimenta da Beira,525,259,266,230,91,101,103,717
Murça,350,185,165,99,62,76,113,383
Penedono,76,43,33,33,10,17,16,93
Peso da Régua,925,456,469,350,141,219,215,1128
Sabrosa,202,111,91,56,26,54,66,211
Santa Marta de Penaguião,350,181,169,100,62,101,87,485
São João da Pesqueira,129,72,57,48,16,28,37,131
Sernancelhe,164,83,81,62,26,37,39,220
Tabuaço,247,126,121,94,47,52,54,295
Tarouca,214,111,103,56,29,51,78,291
Torre de Moncorvo,123,62,61,37,17,26,43,155
Vila Nova de Foz Côa,102,54,48,29,21,21,31,104
Vila Real,1528,753,775,506,272,347,403,2079
Terras de Trás-os-Montes,2566,1351,1215,1020,455,557,534,3141
Alfândega da Fé,134,72,62,62,17,28,27,165
Bragança,587,292,295,243,113,129,102,676
Macedo de Cavaleiros,440,217,223,207,84,81,68,531
Miranda do Douro,122,69,53,46,26,27,23,134
Mirandela,556,305,251,203,101,117,135,704
Mogadouro,249,124,125,92,36,62,59,346
Vila Flor,137,77,60,39,21,34,43,131
Vimioso,76,48,28,23,11,19,23,94
Vinhais,265,147,118,105,46,60,54,360
Centro,39413,19714,19699,15091,6214,8667,9441,49304
Oeste,4562,2143,2419,1901,701,997,963,5363
Alcobaça,649,320,329,287,102,122,138,748
Alenquer,602,264,338,274,89,123,116,739
Arruda dos Vinhos,138,64,74,66,25,24,23,152
Bombarral,109,48,61,31,11,21,46,132
Cadaval,164,85,79,63,26,31,44,207
Caldas da Rainha,584,264,320,231,81,155,117,681
Lourinhã,470,205,265,188,74,106,102,543
Nazaré,185,88,97,80,38,38,29,171
Óbidos,81,47,34,25,8,20,28,98
Peniche,386,198,188,180,79,65,62,381
Sobral de Monte Agraço,122,56,66,46,21,34,21,154
Torres Vedras,1072,504,568,430,147,258,237,1355
Região de Aveiro,6350,3185,3165,2650,1001,1262,1437,8123
Águeda,570,306,264,245,93,109,123,690
Albergaria-a-Velha,428,225,203,176,67,87,98,565
Anadia,241,119,122,57,30,39,115,325
Aveiro,1372,645,727,553,238,290,291,1751
Estarreja,791,408,383,392,145,124,130,1091
Ílhavo,799,406,393,354,109,163,173,983
Murtosa,87,53,34,22,9,30,26,85
Oliveira do Bairro,414,189,225,194,58,74,88,507
Ovar,1249,620,629,511,190,283,265,1623
Sever do Vouga,102,60,42,28,13,16,45,142
Vagos,297,154,143,118,49,47,83,361
Região de Coimbra,7980,4118,3862,2530,1291,1965,2194,10492
Arganil,154,91,63,29,20,35,70,212
Cantanhede,476,227,249,143,65,110,158,609
Coimbra,3142,1649,1493,988,544,828,782,4276
Condeixa-a-Nova,172,87,85,76,19,37,40,191
Figueira da Foz,1569,757,812,564,269,349,387,2097
Góis,67,40,27,18,10,13,26,84
Lousã,425,214,211,142,66,107,110,509
Mealhada,150,78,72,41,23,34,52,183
Mira,168,93,75,53,29,36,50,210
Miranda do Corvo,181,91,90,49,30,36,66,252
Montemor-o-Velho,278,146,132,105,47,69,57,340
Mortágua,77,42,35,21,11,22,23,90
Oliveira do Hospital,334,181,153,88,60,89,97,436
Pampilhosa da Serra,58,38,20,9,10,20,19,73
Penacova,140,74,66,33,13,31,63,188
Penela,50,26,24,19,5,8,18,60
Soure,184,100,84,47,30,47,60,256
Tábua,226,120,106,61,24,59,82,298
Vila Nova de Poiares,129,64,65,44,16,35,34,127
Região de Leiria,4004,1892,2112,1558,637,887,922,5060
Alvaiázere,139,69,70,50,18,35,36,173
Ansião,230,116,114,74,31,61,64,245
Batalha,113,48,65,50,12,28,23,141
Castanheira de Pêra,51,31,20,13,10,10,18,64
Figueiró dos Vinhos,130,69,61,43,19,31,37,161
Leiria,1511,695,816,593,261,342,315,1940
Marinha Grande,705,337,368,291,122,148,144,905
Pedrógão Grande,119,50,69,34,19,32,34,149
Pombal,737,351,386,301,112,145,179,924
Porto de Mós,269,126,143,109,33,55,72,356
Viseu Dão Lafões,5201,2589,2612,1873,775,1138,1415,6568
Aguiar da Beira,90,50,40,31,11,16,32,118
Carregal do Sal,167,82,85,47,20,40,60,211
Castro Daire,335,181,154,97,35,89,114,418
Mangualde,471,229,242,168,63,105,135,605
Nelas,252,129,123,92,40,60,60,341
Oliveira de Frades,56,24,32,17,7,11,21,63
Penalva do Castelo,129,65,64,40,13,31,45,149
Santa Comba Dão,182,90,92,63,19,44,56,216
São Pedro do Sul,172,82,90,41,12,38,81,231
Sátão,272,133,139,111,51,47,63,325
Tondela,297,162,135,76,35,64,122,385
Vila Nova de Paiva,96,51,45,31,13,22,30,104
Viseu,2623,1277,1346,1047,449,558,569,3339
Vouzela,59,34,25,12,7,13,27,63
Beira Baixa,1847,968,879,781,288,355,423,2238
Castelo Branco,1158,584,574,512,177,211,258,1378
Idanha-a-Nova,377,208,169,158,78,74,67,472
Oleiros,42,24,18,7,4,5,26,64
Penamacor,112,72,40,39,11,25,37,147
Proença-a-Nova,89,45,44,31,8,24,26,102
Vila Velha de Ródão,69,35,34,34,10,16,9,74
Médio Tejo,3934,1955,1979,1633,628,833,840,4593
Abrantes,963,498,465,407,167,214,175,1155
Alcanena,98,47,51,37,16,19,26,113
Constância,105,44,61,45,16,24,20,126
Entroncamento,508,223,285,255,90,106,57,518
Ferreira do Zêzere,79,33,46,24,11,15,29,107
Mação,101,64,37,23,16,27,35,123
Ourém,295,148,147,103,41,65,86,334
Sardoal,87,48,39,42,13,19,13,72
Sertã,255,141,114,85,30,58,82,313
Tomar,817,395,422,352,122,170,173,973
Torres Novas,413,203,210,160,67,85,101,510
Vila de Rei,40,20,20,19,8,5,8,31
Vila Nova da Barquinha,173,91,82,81,31,26,35,217
Beiras e Serra da Estrela,5535,2864,2671,2165,893,1230,1247,6867
Almeida,144,87,57,39,27,24,54,207
Belmonte,215,112,103,79,33,53,50,269
Celorico da Beira,169,81,88,58,35,28,48,228
Covilhã,1191,620,571,476,191,281,243,1451
Figueira de Castelo Rodrigo,278,144,134,140,52,54,32,342
Fornos de Algodres,91,46,45,29,13,26,23,99
Fundão,772,403,369,286,101,187,198,1042
Gouveia,362,188,174,147,63,86,66,409
Guarda,1051,536,515,453,185,200,213,1249
Manteigas,58,26,32,15,11,12,20,77
Mêda,84,40,44,29,10,20,25,90
Pinhel,145,85,60,58,14,35,38,172
Sabugal,253,138,115,104,44,50,55,319
Seia,608,302,306,218,96,147,147,771
Trancoso,114,56,58,34,18,27,35,142
A. M. Lisboa,75440,34914,40526,34142,12114,15221,13963,94223
Alcochete,310,149,161,136,49,67,58,384
Almada,6526,2992,3534,2940,1010,1337,1239,8294
Amadora,5161,2209,2952,2562,847,964,788,5962
Barreiro,3048,1389,1659,1451,528,552,517,3929
Cascais,3780,1758,2022,1517,519,843,901,4741
Lisboa,20657,10380,10277,8914,3458,4365,3920,27067
Loures,5263,2418,2845,2492,857,986,928,6543
Mafra,827,388,439,343,114,199,171,979
Moita,3173,1367,1806,1566,502,570,535,3933
Montijo,1877,867,1010,882,323,351,321,2345
Odivelas,3326,1503,1823,1532,523,661,610,4099
Oeiras,1957,867,1090,805,279,411,462,2234
Palmela,844,382,462,346,108,194,196,933
Seixal,4634,2047,2587,2124,781,908,821,5731
Sesimbra,1180,500,680,535,171,263,211,1491
Setúbal,3496,1665,1831,1617,581,715,583,4356
Sintra,7098,3019,4079,3292,1073,1402,1331,8357
Vila Franca de Xira,2283,1014,1269,1088,391,433,371,2845
Alentejo,18639,9290,9349,9266,3224,3461,2688,22346
Alentejo Litoral,1419,681,738,553,231,304,331,1721
Alcácer do Sal,140,68,72,62,19,29,30,164
Grândola,269,131,138,110,43,52,64,321
Odemira,317,165,152,91,51,86,89,410
Santiago do Cacém,325,150,175,115,47,69,94,406
Sines,368,167,201,175,71,68,54,420
Baixo Alentejo,5336,2742,2594,2976,903,841,616,6581
Aljustrel,342,180,162,193,59,55,35,464
Almodôvar,100,45,55,46,12,19,23,118
Alvito,60,37,23,33,8,11,8,84
Barrancos,67,30,37,32,8,22,5,67
Beja,1508,782,726,841,277,242,148,1876
Castro Verde,125,66,59,62,27,17,19,157
Cuba,171,93,78,86,30,37,18,191
Ferreira do Alentejo,220,108,112,111,39,34,36,250
Mértola,155,84,71,60,26,36,33,204
Moura,1473,747,726,913,238,191,131,1753
Ourique,70,37,33,20,6,23,21,81
Serpa,735,375,360,405,124,114,92,934
Vidigueira,310,158,152,174,49,40,47,402
Lezíria do Tejo,4426,2177,2249,2067,724,898,737,5152
Almeirim,381,187,194,179,67,74,61,359
Alpiarça,81,42,39,33,15,22,11,60
Azambuja,465,213,252,210,78,77,100,658
Benavente,641,307,334,340,119,99,83,735
Cartaxo,220,88,132,87,27,49,57,260
Chamusca,128,58,70,52,25,25,26,123
Coruche,530,265,265,302,93,83,52,620
Golegã,82,43,39,31,10,25,16,87
Rio Maior,275,124,151,130,37,67,41,261
Salvaterra de Magos,359,181,178,163,56,78,62,378
Santarém,1264,669,595,540,197,299,228,1613
Alto Alentejo,3712,1854,1858,1798,675,696,543,4447
Alter do Chão,137,65,72,65,27,27,18,143
Arronches,29,16,13,12,3,7,7,28
Avis,231,109,122,111,48,45,27,315
Campo Maior,363,197,166,201,78,43,41,446
Castelo de Vide,45,27,18,15,8,11,11,37
Crato,105,57,48,41,17,31,16,124
Elvas,1264,610,654,651,218,224,171,1554
Fronteira,30,14,16,10,4,6,10,40
Gavião,68,38,30,28,14,13,13,90
Marvão,65,37,28,26,10,22,7,71
Monforte,343,176,167,200,74,48,21,384
Nisa,163,85,78,65,20,43,35,211
Ponte de Sor,351,163,188,159,60,70,62,396
Portalegre,374,188,186,142,65,81,86,418
Sousel,144,72,72,72,29,25,18,188
Alentejo Central,3746,1836,1910,1872,691,722,461,4445
Alandroal,43,14,29,15,6,12,10,41
Arraiolos,50,27,23,15,3,23,9,55
Borba,282,131,151,144,50,55,33,347
Estremoz,469,236,233,237,90,87,55,603
Évora,1147,553,594,544,204,228,171,1370
Montemor-o-Novo,183,101,82,83,35,40,25,193
Mora,44,20,24,19,8,10,7,43
Mourão,302,148,154,185,61,43,13,382
Portel,152,82,70,86,28,27,11,195
Redondo,157,68,89,76,26,34,21,174
Reguengos de Monsaraz,454,220,234,234,97,77,46,548
Vendas Novas,196,105,91,107,40,32,17,202
Viana do Alentejo,127,60,67,67,19,19,22,146
Vila Viçosa,140,71,69,60,24,35,21,146
Algarve,10208,5166,5042,4350,1951,2079,1828,12762
Albufeira,1053,561,492,408,261,221,163,1287
Alcoutim,26,15,11,8,3,7,8,31
Aljezur,77,42,35,16,6,26,29,103
Castro Marim,179,90,89,96,33,29,21,217
Faro,1761,887,874,850,358,304,249,2297
Lagoa,581,294,287,270,121,94,96,745
Lagos,504,239,265,197,73,122,112,612
Loulé,1424,715,709,568,275,291,290,1879
Monchique,72,50,22,10,8,17,37,118
Olhão,1039,507,532,455,191,213,180,1246
Portimão,1859,953,906,800,341,397,321,2456
São Brás de Alportel,169,94,75,54,24,41,50,220
Silves,526,236,290,233,91,104,98,549
Tavira,362,189,173,137,58,90,77,456
Vila do Bispo,50,22,28,18,8,15,9,63
Vila Real de Santo António,526,272,254,230,100,108,88,483
R. A. Açores,17283,8696,8587,8142,3721,3483,1937,17463
Santa Maria,159,75,84,64,42,32,21,154
Vila do Porto,159,75,84,64,42,32,21,154
São Miguel,13488,6875,6613,6456,2918,2715,1399,13740
Lagoa (R.A.A.),1324,681,643,642,271,275,136,1236
Nordeste,392,202,190,172,89,89,42,320
Ponta Delgada,5767,2964,2803,2595,1255,1208,709,6672
Povoação,553,271,282,236,110,135,72,470
Ribeira Grande,4768,2422,2346,2497,1063,855,353,4414
Vila Franca do Campo,684,335,349,314,130,153,87,628
Terceira,2524,1191,1333,1146,514,508,356,2517
Angra do Heroísmo,1471,702,769,680,290,296,205,1417
Vila da Praia da Vitória,1053,489,564,466,224,212,151,1100
Graciosa,285,148,137,144,72,44,25,234
Santa Cruz da Graciosa,285,148,137,144,72,44,25,234
São Jorge,157,72,85,54,32,29,42,167
Calheta (R.A.A.),62,27,35,25,10,11,16,63
Velas,95,45,50,29,22,18,26,104
Pico,278,139,139,115,65,64,34,244
Lajes do Pico,69,33,36,32,18,12,7,59
Madalena,145,78,67,60,34,37,14,122
São Roque do Pico,64,28,36,23,13,15,13,64
Faial,323,162,161,133,68,70,52,338
Horta,323,162,161,133,68,70,52,338
Flores,58,30,28,23,…,…,8,60
Lajes das Flores,22,11,11,11,...,...,...,26
Santa Cruz das Flores,36,19,17,12,...,13,...,35
Corvo,11,4,7,7,…,…,0,9
Corvo,11,4,7,7,...,...,0,9
R. A. Madeira,7505,3584,3921,2736,1140,1777,1852,9124
Calheta (R.A.M.),383,185,198,126,61,80,116,499
Câmara de Lobos,885,434,451,345,127,223,190,1038
Funchal,3801,1796,2005,1403,637,918,843,4732
Machico,533,249,284,198,66,137,132,593
Ponta do Sol,221,90,131,77,24,45,75,294
Porto Moniz,59,34,25,12,7,11,29,93
Ribeira Brava,290,141,149,98,30,72,90,337
Santa Cruz,911,440,471,353,143,191,224,979
Santana,256,133,123,82,33,61,80,323
São Vicente,112,58,54,26,9,23,54,148
Porto Santo,54,24,30,16,3,16,19,88
