,"Casamentos, Total (N.º)","Casamentos, Entre pessoas de sexo oposto, Total (N.º)","Casamentos, Entre pessoas de sexo oposto, dos quais, Só civis (N.º)","Casamentos, Entre pessoas de sexo oposto, dos quais, Católicos (N.º)","Casamentos, Entre pessoas do mesmo sexo, Masculino, Católicos (N.º)","Casamentos, Entre pessoas do mesmo sexo, Feminino, Católicos (N.º)","Casamentos dissolvidos, Entre pessoas do mesmo sexo, Total, Católicos (N.º)","Casamentos dissolvidos, Entre pessoas do mesmo sexo, por divórcio, Católicos (N.º)","Casamentos dissolvidos, Entre pessoas do mesmo sexo, por morte, Católicos (N.º)","População estrangeira a quem foi concedido título de residência, Entre pessoas do mesmo sexo, por morte, HM (N.º)","População estrangeira a quem foi concedido título de residência, Entre pessoas do mesmo sexo, por morte, H (N.º)","População estrangeira a quem foi concedido título de residência, Entre pessoas do mesmo sexo, por morte, M (N.º)","População estrangeira com estatuto de residente, Entre pessoas do mesmo sexo, por morte, HM (N.º)","População estrangeira com estatuto de residente, Entre pessoas do mesmo sexo, por morte, H (N.º)","População estrangeira com estatuto de residente, Entre pessoas do mesmo sexo, por morte, M (N.º)"
Portugal,18902,18457,16087,2263,236,209,66581,17295,49286,118124,63100,55024,661607,335924,325683
Continente,17732,17317,15077,2134,217,198,63523,16214,47309,116211,62148,54063,648079,329300,318779
Norte,6580,6483,5299,1151,44,53,23014,6220,16794,19826,10042,9784,90253,43335,46918
Alto Minho,411,408,340,64,2,1,1685,371,1314,1609,899,710,6166,3237,2929
Arcos de Valdevez,31,31,29,2,0,0,162,28,134,50,23,27,299,134,165
Caminha,23,23,17,6,0,0,106,25,81,109,65,44,513,272,241
Melgaço,10,10,8,2,0,0,88,15,73,24,11,13,120,48,72
Monção,24,23,23,0,1,0,175,28,147,192,90,102,733,376,357
Paredes de Coura,2,2,2,0,0,0,73,9,64,45,23,22,150,79,71
Ponte da Barca,29,29,24,5,0,0,94,21,73,27,16,11,126,65,61
Ponte de Lima,64,64,47,17,0,0,252,47,205,72,41,31,446,244,202
Valença,24,24,20,2,0,0,112,25,87,337,188,149,845,441,404
Viana do Castelo,182,180,151,29,1,1,567,167,400,592,333,259,2473,1301,1172
Vila Nova de Cerveira,22,22,19,1,0,0,56,6,50,161,109,52,461,277,184
Cávado,839,821,671,148,11,7,2263,718,1545,3300,1650,1650,15134,7291,7843
Amares,40,40,39,1,0,0,127,38,89,92,50,42,371,179,192
Barcelos,190,187,142,44,2,1,636,198,438,375,201,174,1493,747,746
Braga,448,436,349,86,7,5,952,336,616,2531,1223,1308,11774,5595,6179
Esposende,58,57,50,7,1,0,213,65,148,162,89,73,818,428,390
Terras de Bouro,15,15,14,1,0,0,44,6,38,10,4,6,70,29,41
Vila Verde,88,86,77,9,1,1,291,75,216,130,83,47,608,313,295
Ave,582,578,472,105,0,4,2451,662,1789,1124,661,463,5950,2969,2981
Cabeceiras de Basto,23,23,20,3,0,0,111,24,87,21,17,4,144,78,66
Fafe,74,73,61,11,0,1,327,96,231,71,41,30,371,159,212
Guimarães,174,172,150,22,0,2,836,223,613,405,231,174,2481,1227,1254
Mondim de Basto,25,25,22,3,0,0,43,7,36,15,4,11,66,30,36
Póvoa de Lanhoso,36,35,35,0,0,1,149,47,102,66,40,26,299,160,139
Vieira do Minho,27,27,17,10,0,0,70,13,57,13,5,8,142,56,86
Vila Nova de Famalicão,181,181,132,49,0,0,793,214,579,503,309,194,2234,1155,1079
Vizela,42,42,35,7,0,0,122,38,84,30,14,16,213,104,109
A. M. Porto,3418,3353,2791,545,31,34,11080,3280,7800,11645,5788,5857,52655,25034,27621
Arouca,29,27,24,3,1,1,138,39,99,23,13,10,125,71,54
Espinho,126,125,111,12,0,1,245,65,180,124,59,65,827,367,460
Gondomar,168,168,131,37,0,0,1059,281,778,553,283,270,2987,1402,1585
Maia,212,207,175,32,3,2,754,248,506,635,282,353,3614,1646,1968
Matosinhos,211,205,172,33,3,3,1138,345,793,1041,489,552,5804,2728,3076
Oliveira de Azeméis,69,69,54,15,0,0,449,118,331,172,91,81,991,454,537
Paredes,90,88,61,27,2,0,480,159,321,178,88,90,791,369,422
Porto,940,907,790,114,16,17,1555,395,1160,4717,2387,2330,17156,8418,8738
Póvoa de Varzim,164,162,139,21,1,1,421,113,308,541,276,265,2221,1065,1156
Santa Maria da Feira,227,226,169,56,1,0,864,297,567,306,139,167,1820,795,1025
Santo Tirso,107,106,81,24,0,1,475,116,359,83,45,38,576,250,326
São João da Madeira,77,75,70,5,0,2,161,65,96,208,98,110,865,409,456
Trofa,74,74,57,17,0,0,221,69,152,140,76,64,651,328,323
Vale de Cambra,67,67,59,8,0,0,132,32,100,98,50,48,385,201,184
Valongo,217,215,177,36,1,1,590,185,405,360,195,165,1634,773,861
Vila do Conde,205,205,168,37,0,0,507,171,336,407,232,175,2488,1310,1178
Vila Nova de Gaia,435,427,353,68,3,5,1891,582,1309,2059,985,1074,9720,4448,5272
Alto Tâmega,156,155,146,9,0,1,694,118,576,184,101,83,1285,609,676
Boticas,4,4,4,0,0,0,43,2,41,10,4,6,50,23,27
Chaves,97,96,89,7,0,1,277,61,216,92,42,50,682,296,386
Montalegre,12,12,12,0,0,0,92,16,76,14,11,3,98,50,48
Ribeira de Pena,12,12,12,0,0,0,38,9,29,18,15,3,101,69,32
Valpaços,18,18,18,0,0,0,145,16,129,21,8,13,177,67,110
Vila Pouca de Aguiar,13,13,11,2,0,0,99,14,85,29,21,8,177,104,73
Tâmega e Sousa,746,741,514,218,0,5,2594,662,1932,614,340,274,2891,1352,1539
Amarante,103,103,69,30,0,0,345,82,263,69,35,34,416,174,242
Baião,29,29,14,15,0,0,128,25,103,32,20,12,105,55,50
Castelo de Paiva,37,37,28,9,0,0,100,23,77,37,28,9,98,54,44
Celorico de Basto,20,20,20,0,0,0,123,21,102,8,6,2,82,35,47
Cinfães,21,21,13,8,0,0,145,39,106,14,12,2,82,42,40
Felgueiras,95,95,65,30,0,0,319,89,230,67,37,30,387,180,207
Lousada,83,83,55,28,0,0,267,66,201,95,62,33,367,198,169
Marco de Canaveses,116,115,91,23,0,1,303,94,209,142,62,80,418,185,233
Paços de Ferreira,68,67,42,24,0,1,343,108,235,75,35,40,361,160,201
Penafiel,148,145,97,45,0,3,440,107,333,72,41,31,521,239,282
Resende,26,26,20,6,0,0,81,8,73,3,2,1,54,30,24
Douro,304,304,253,51,0,0,1365,259,1106,402,203,199,2476,1177,1299
Alijó,8,8,7,1,0,0,84,15,69,7,3,4,96,41,55
Armamar,8,8,4,4,0,0,46,5,41,4,1,3,53,22,31
Carrazeda de Ansiães,11,11,9,2,0,0,47,6,41,21,16,5,125,70,55
Freixo de Espada à Cinta,4,4,4,0,0,0,44,6,38,4,2,2,101,50,51
Lamego,41,41,31,10,0,0,168,31,137,31,19,12,151,61,90
Mesão Frio,12,12,10,2,0,0,27,4,23,1,0,1,16,7,9
Moimenta da Beira,17,17,11,6,0,0,68,14,54,17,6,11,140,74,66
Murça,7,7,5,2,0,0,42,6,36,3,2,1,40,13,27
Penedono,7,7,7,0,0,0,22,3,19,2,0,2,25,10,15
Peso da Régua,29,29,26,3,0,0,95,23,72,16,7,9,107,48,59
Sabrosa,5,5,5,0,0,0,45,8,37,3,0,3,37,16,21
Santa Marta de Penaguião,12,12,11,1,0,0,38,7,31,5,2,3,66,39,27
São João da Pesqueira,11,11,9,2,0,0,69,12,57,11,6,5,78,33,45
Sernancelhe,7,7,7,0,0,0,33,4,29,8,7,1,49,30,19
Tabuaço,11,11,11,0,0,0,36,3,33,6,3,3,35,17,18
Tarouca,15,15,11,4,0,0,51,8,43,16,7,9,64,30,34
Torre de Moncorvo,6,6,6,0,0,0,73,6,67,5,1,4,91,37,54
Vila Nova de Foz Côa,8,8,8,0,0,0,64,8,56,18,6,12,189,98,91
Vila Real,85,85,71,14,0,0,313,90,223,224,115,109,1013,481,532
Terras de Trás-os-Montes,124,123,112,11,0,1,882,150,732,948,400,548,3696,1666,2030
Alfândega da Fé,1,1,1,0,0,0,49,8,41,14,8,6,163,81,82
Bragança,44,43,38,5,0,1,270,50,220,707,292,415,2257,1017,1240
Macedo de Cavaleiros,18,18,17,1,0,0,103,27,76,53,22,31,225,100,125
Miranda do Douro,6,6,6,0,0,0,51,5,46,13,5,8,103,42,61
Mirandela,29,29,27,2,0,0,155,29,126,113,56,57,538,244,294
Mogadouro,14,14,11,3,0,0,84,15,69,10,3,7,85,37,48
Vila Flor,2,2,2,0,0,0,36,3,33,21,8,13,220,103,117
Vimioso,5,5,5,0,0,0,54,6,48,12,4,8,57,27,30
Vinhais,5,5,5,0,0,0,80,7,73,5,2,3,48,15,33
Centro,3741,3695,3221,451,19,27,15743,3591,12152,17756,9160,8596,87835,44072,43763
Oeste,703,693,626,61,6,4,2437,616,1821,3976,2185,1791,21199,10981,10218
Alcobaça,76,74,61,12,1,1,395,104,291,462,263,199,2479,1281,1198
Alenquer,90,87,86,1,2,1,267,63,204,503,256,247,3139,1570,1569
Arruda dos Vinhos,37,35,32,3,0,2,88,29,59,127,72,55,726,375,351
Bombarral,51,50,49,1,1,0,89,18,71,100,59,41,566,291,275
Cadaval,19,19,15,1,0,0,106,17,89,80,40,40,435,213,222
Caldas da Rainha,83,82,76,6,1,0,377,96,281,706,365,341,3610,1824,1786
Lourinhã,56,56,53,3,0,0,159,28,131,338,181,157,1578,814,764
Nazaré,59,59,55,4,0,0,89,31,58,185,94,91,982,491,491
Óbidos,27,27,23,4,0,0,88,23,65,172,90,82,944,474,470
Peniche,45,45,39,6,0,0,179,39,140,272,142,130,1430,730,700
Sobral de Monte Agraço,29,29,26,3,0,0,58,13,45,84,46,38,381,192,189
Torres Vedras,131,130,111,17,1,0,542,155,387,947,577,370,4929,2726,2203
Região de Aveiro,748,744,637,102,2,2,2347,637,1710,2437,1199,1238,13006,6278,6728
Águeda,54,54,45,9,0,0,302,94,208,302,151,151,1353,696,657
Albergaria-a-Velha,36,36,33,2,0,0,145,42,103,93,49,44,548,268,280
Anadia,46,46,43,3,0,0,196,40,156,92,42,50,701,336,365
Aveiro,233,231,202,25,1,1,441,110,331,1028,500,528,5445,2605,2840
Estarreja,53,53,40,13,0,0,185,48,137,87,41,46,635,331,304
Ílhavo,54,54,42,12,0,0,241,76,165,273,128,145,1375,624,751
Murtosa,55,55,45,10,0,0,68,12,56,46,22,24,205,97,108
Oliveira do Bairro,53,53,45,8,0,0,158,53,105,193,100,93,945,438,507
Ovar,89,89,76,13,0,0,356,104,252,179,91,88,981,488,493
Sever do Vouga,15,15,12,3,0,0,95,15,80,37,19,18,201,89,112
Vagos,60,58,54,4,1,1,160,43,117,107,56,51,617,306,311
Região de Coimbra,767,752,641,109,4,11,3063,718,2345,3975,1889,2086,17642,8597,9045
Arganil,17,17,15,2,0,0,92,14,78,169,88,81,734,387,347
Cantanhede,57,57,54,3,0,0,286,58,228,142,74,68,721,346,375
Coimbra,290,280,216,63,3,7,864,247,617,2102,933,1169,7852,3612,4240
Condeixa-a-Nova,15,15,13,2,0,0,103,31,72,46,15,31,366,156,210
Figueira da Foz,127,123,121,2,1,3,432,126,306,496,231,265,2737,1384,1353
Góis,4,4,4,0,0,0,34,2,32,71,44,27,327,183,144
Lousã,29,28,24,4,0,1,86,21,65,85,44,41,556,268,288
Mealhada,23,23,20,3,0,0,134,32,102,63,37,26,367,187,180
Mira,19,19,18,1,0,0,96,22,74,67,30,37,279,138,141
Miranda do Corvo,13,13,11,2,0,0,97,14,83,48,25,23,378,191,187
Montemor-o-Velho,41,41,32,9,0,0,171,33,138,47,26,21,258,138,120
Mortágua,16,16,14,2,0,0,62,5,57,54,25,29,273,144,129
Oliveira do Hospital,27,27,25,2,0,0,136,31,105,196,112,84,824,452,372
Pampilhosa da Serra,3,3,3,0,0,0,33,2,31,8,5,3,40,19,21
Penacova,22,22,20,2,0,0,101,17,84,95,46,49,260,122,138
Penela,17,17,14,2,0,0,51,7,44,62,37,25,378,209,169
Soure,20,20,12,8,0,0,152,29,123,48,22,26,275,126,149
Tábua,14,14,13,1,0,0,79,13,66,133,71,62,694,363,331
Vila Nova de Poiares,13,13,12,1,0,0,54,14,40,43,24,19,323,172,151
Região de Leiria,394,385,340,41,4,5,1914,461,1453,2762,1429,1333,14769,7513,7256
Alvaiázere,6,6,5,1,0,0,36,4,32,138,82,56,523,275,248
Ansião,17,17,13,4,0,0,88,13,75,65,33,32,410,215,195
Batalha,44,43,35,6,1,0,111,32,79,84,40,44,600,306,294
Castanheira de Pêra,2,2,2,0,0,0,29,1,28,43,25,18,128,68,60
Figueiró dos Vinhos,10,10,9,1,0,0,44,6,38,62,32,30,297,150,147
Leiria,165,159,145,12,3,3,770,212,558,1297,661,636,6881,3339,3542
Marinha Grande,59,57,53,4,0,2,253,70,183,468,248,220,2580,1324,1256
Pedrógão Grande,5,5,4,1,0,0,35,4,31,187,92,95,574,303,271
Pombal,67,67,58,9,0,0,384,82,302,284,147,137,1958,1122,836
Porto de Mós,19,19,16,3,0,0,164,37,127,134,69,65,818,411,407
Viseu Dão Lafões,394,389,340,49,3,2,1820,357,1463,1215,649,566,5534,2743,2791
Aguiar da Beira,4,4,3,1,0,0,42,3,39,3,3,0,44,24,20
Carregal do Sal,12,12,12,0,0,0,68,11,57,32,14,18,187,83,104
Castro Daire,24,24,20,4,0,0,119,17,102,14,8,6,159,77,82
Mangualde,42,42,39,3,0,0,132,26,106,72,40,32,388,218,170
Nelas,21,21,18,3,0,0,107,25,82,41,27,14,242,121,121
Oliveira de Frades,25,25,23,2,0,0,66,15,51,125,84,41,335,200,135
Penalva do Castelo,6,6,2,4,0,0,52,10,42,23,10,13,61,29,32
Santa Comba Dão,18,18,13,5,0,0,92,11,81,70,43,27,266,142,124
São Pedro do Sul,21,21,19,2,0,0,116,15,101,56,26,30,213,98,115
Sátão,17,17,16,1,0,0,78,18,60,11,5,6,91,41,50
Tondela,46,45,41,4,1,0,186,27,159,104,62,42,365,195,170
Vila Nova de Paiva,9,9,9,0,0,0,42,5,37,3,1,2,53,20,33
Viseu,127,123,105,18,2,2,653,165,488,630,310,320,3014,1440,1574
Vouzela,22,22,20,2,0,0,67,9,58,31,16,15,116,55,61
Beira Baixa,120,119,109,10,0,1,694,97,597,940,516,424,3365,1786,1579
Castelo Branco,100,99,91,8,0,1,399,78,321,559,303,256,1964,993,971
Idanha-a-Nova,6,6,5,1,0,0,103,4,99,151,85,66,497,276,221
Oleiros,5,5,5,0,0,0,37,4,33,42,26,16,125,78,47
Penamacor,0,0,0,0,0,0,49,1,48,112,53,59,404,209,195
Proença-a-Nova,9,9,8,1,0,0,81,8,73,38,24,14,216,120,96
Vila Velha de Ródão,0,0,0,0,0,0,25,2,23,38,25,13,159,110,49
Médio Tejo,372,370,319,45,0,2,1753,408,1345,1227,643,584,7198,3544,3654
Abrantes,48,48,42,6,0,0,298,65,233,81,48,33,576,286,290
Alcanena,27,27,21,2,0,0,76,23,53,42,16,26,407,194,213
Constância,10,10,10,0,0,0,32,11,21,4,1,3,47,17,30
Entroncamento,26,26,26,0,0,0,135,34,101,154,77,77,769,347,422
Ferreira do Zêzere,14,14,13,1,0,0,74,15,59,51,27,24,391,197,194
Mação,5,5,4,1,0,0,61,4,57,32,14,18,130,56,74
Ourém,71,71,59,12,0,0,297,73,224,367,188,179,2338,1188,1150
Sardoal,9,9,8,0,0,0,34,6,28,9,7,2,56,32,24
Sertã,17,16,14,2,0,1,113,18,95,136,73,63,518,284,234
Tomar,74,73,61,11,0,1,313,78,235,234,125,109,1156,561,595
Torres Novas,28,28,24,4,0,0,237,64,173,78,42,36,626,299,327
Vila de Rei,4,4,3,1,0,0,27,2,25,25,16,9,81,39,42
Vila Nova da Barquinha,39,39,34,5,0,0,56,15,41,14,9,5,103,44,59
Beiras e Serra da Estrela,243,243,209,34,0,0,1715,297,1418,1224,650,574,5122,2630,2492
Almeida,2,2,2,0,0,0,69,7,62,11,5,6,100,40,60
Belmonte,4,4,4,0,0,0,49,5,44,5,3,2,73,39,34
Celorico da Beira,17,17,17,0,0,0,57,15,42,42,25,17,140,70,70
Covilhã,49,49,42,7,0,0,336,70,266,458,262,196,1614,857,757
Figueira de Castelo Rodrigo,8,8,8,0,0,0,47,10,37,5,3,2,46,22,24
Fornos de Algodres,4,4,4,0,0,0,36,6,30,21,11,10,71,35,36
Fundão,28,28,24,4,0,0,233,36,197,255,142,113,1062,566,496
Gouveia,16,16,14,2,0,0,101,11,90,38,19,19,225,112,113
Guarda,61,61,49,12,0,0,257,69,188,246,111,135,984,496,488
Manteigas,4,4,4,0,0,0,27,1,26,9,4,5,28,11,17
Mêda,5,5,4,1,0,0,46,6,40,4,4,0,48,26,22
Pinhel,4,4,4,0,0,0,90,8,82,13,6,7,80,40,40
Sabugal,2,2,2,0,0,0,119,10,109,9,6,3,120,54,66
Seia,32,32,27,5,0,0,183,33,150,100,46,54,447,218,229
Trancoso,7,7,4,3,0,0,65,10,55,8,3,5,84,44,40
A. M. Lisboa,5406,5176,4751,387,132,98,16680,4722,11958,55449,29470,25979,330413,166831,163582
Alcochete,53,51,48,3,0,2,104,42,62,168,89,79,1254,642,612
Almada,249,238,222,14,7,4,1103,304,799,2867,1409,1458,15471,7560,7911
Amadora,111,110,95,14,1,0,1005,273,732,3470,1818,1652,23458,11646,11812
Barreiro,146,139,133,5,5,2,616,166,450,992,487,505,5197,2445,2752
Cascais,377,363,338,24,7,7,1211,337,874,5020,2539,2481,32939,15856,17083
Lisboa,1943,1827,1621,195,78,38,3291,787,2504,19440,10999,8441,106971,57509,49462
Loures,269,262,246,15,4,3,1182,317,865,3115,1671,1444,21077,10532,10545
Mafra,173,168,145,22,4,1,457,167,290,1016,512,504,5286,2585,2701
Moita,108,108,105,3,0,0,389,92,297,759,375,384,3961,1847,2114
Montijo,90,89,82,7,0,1,353,111,242,904,535,369,5232,2829,2403
Odivelas,x,x,x,x,x,x,796,196,600,3422,1893,1529,19946,10362,9584
Oeiras,306,291,280,10,8,7,932,235,697,2214,1103,1111,13485,6311,7174
Palmela,104,101,95,5,0,3,408,115,293,574,306,268,3144,1555,1589
Seixal,249,240,221,10,4,5,1009,319,690,2037,1027,1010,11624,5591,6033
Sesimbra,145,140,136,2,4,1,310,98,212,516,258,258,2918,1424,1494
Setúbal,343,334,323,8,4,5,801,257,544,1491,781,710,8674,4373,4301
Sintra,582,559,525,32,6,17,1909,635,1274,6163,3048,3115,41155,19621,21534
Vila Franca de Xira,158,156,136,18,0,2,804,271,533,1281,620,661,8621,4143,4478
Alentejo,1155,1139,1027,106,8,8,5255,983,4272,6821,4382,2439,36024,20604,15420
Alentejo Litoral,134,132,126,6,2,0,646,124,522,2527,1774,753,13058,8228,4830
Alcácer do Sal,17,17,17,0,0,0,97,17,80,73,44,29,482,290,192
Grândola,19,19,18,1,0,0,98,14,84,140,86,54,758,369,389
Odemira,25,23,22,1,2,0,149,25,124,1984,1457,527,9615,6423,3192
Santiago do Cacém,38,38,35,3,0,0,211,48,163,203,126,77,1244,654,590
Sines,35,35,34,1,0,0,91,20,71,127,61,66,959,492,467
Baixo Alentejo,201,199,188,10,1,1,896,158,738,953,683,270,4480,2623,1857
Aljustrel,6,6,6,0,0,0,65,11,54,26,24,2,148,87,61
Almodôvar,4,4,4,0,0,0,53,9,44,33,19,14,225,109,116
Alvito,8,7,7,0,1,0,19,2,17,16,6,10,78,36,42
Barrancos,4,4,3,1,0,0,8,2,6,0,0,0,18,10,8
Beja,78,78,73,4,0,0,237,57,180,376,259,117,1617,950,667
Castro Verde,13,13,12,1,0,0,65,9,56,29,14,15,191,107,84
Cuba,7,7,4,3,0,0,42,1,41,130,123,7,291,206,85
Ferreira do Alentejo,21,21,21,0,0,0,61,11,50,160,134,26,643,439,204
Mértola,9,9,9,0,0,0,48,5,43,38,20,18,177,87,90
Moura,26,25,25,0,0,1,112,24,88,17,10,7,250,144,106
Ourique,7,7,6,1,0,0,42,6,36,54,25,29,374,185,189
Serpa,13,13,13,0,0,0,103,18,85,63,43,20,317,178,139
Vidigueira,5,5,5,0,0,0,41,3,38,11,6,5,151,85,66
Lezíria do Tejo,413,409,362,43,1,3,1656,367,1289,1977,1205,772,10946,5912,5034
Almeirim,36,36,34,2,0,0,151,31,120,172,122,50,873,482,391
Alpiarça,9,8,8,0,0,1,66,6,60,38,24,14,344,195,149
Azambuja,31,31,29,2,0,0,146,38,108,278,144,134,1177,590,587
Benavente,65,62,59,3,1,2,184,59,125,265,143,122,2161,1077,1084
Cartaxo,36,36,32,4,0,0,148,38,110,166,85,81,875,454,421
Chamusca,11,11,10,1,0,0,85,10,75,12,9,3,89,45,44
Coruche,5,5,4,1,0,0,150,22,128,45,31,14,336,181,155
Golegã,17,17,17,0,0,0,33,9,24,12,6,6,81,41,40
Rio Maior,37,37,32,4,0,0,154,37,117,358,257,101,1548,960,588
Salvaterra de Magos,44,44,36,6,0,0,142,23,119,80,39,41,522,255,267
Santarém,122,122,101,20,0,0,397,94,303,551,345,206,2940,1632,1308
Alto Alentejo,145,142,129,13,2,1,915,146,769,448,236,212,2755,1366,1389
Alter do Chão,4,4,2,2,0,0,35,7,28,11,5,6,122,61,61
Arronches,1,0,0,0,1,0,32,0,32,11,6,5,57,31,26
Avis,6,6,6,0,0,0,23,2,21,5,2,3,60,35,25
Campo Maior,7,7,6,1,0,0,65,13,52,22,11,11,249,123,126
Castelo de Vide,3,3,3,0,0,0,28,5,23,19,9,10,123,58,65
Crato,9,9,9,0,0,0,45,4,41,3,2,1,65,25,40
Elvas,24,23,20,3,1,0,171,35,136,75,33,42,587,250,337
Fronteira,10,10,10,0,0,0,24,2,22,0,0,0,71,36,35
Gavião,6,6,6,0,0,0,40,3,37,2,1,1,12,7,5
Marvão,4,4,4,0,0,0,35,2,33,53,26,27,178,92,86
Monforte,3,3,2,1,0,0,29,2,27,7,4,3,41,26,15
Nisa,3,3,3,0,0,0,64,10,54,24,13,11,83,44,39
Ponte de Sor,19,19,19,0,0,0,107,15,92,95,63,32,418,239,179
Portalegre,42,41,35,6,0,1,186,44,142,115,58,57,599,290,309
Sousel,4,4,4,0,0,0,31,2,29,6,3,3,90,49,41
Alentejo Central,262,257,222,34,2,3,1142,188,954,916,484,432,4785,2475,2310
Alandroal,5,5,5,0,0,0,42,2,40,20,17,3,115,69,46
Arraiolos,12,12,10,2,0,0,47,7,40,28,15,13,158,84,74
Borba,3,3,3,0,0,0,45,6,39,9,4,5,130,53,77
Estremoz,16,15,12,3,0,1,92,13,79,49,28,21,341,170,171
Évora,124,121,102,18,1,2,331,78,253,537,267,270,2300,1161,1139
Montemor-o-Novo,33,33,28,5,0,0,149,17,132,67,35,32,424,215,209
Mora,1,1,1,0,0,0,38,3,35,2,1,1,45,24,21
Mourão,4,4,4,0,0,0,21,3,18,8,5,3,45,28,17
Portel,5,5,5,0,0,0,41,6,35,9,5,4,120,64,56
Redondo,14,14,13,1,0,0,44,5,39,12,5,7,209,113,96
Reguengos de Monsaraz,21,20,19,1,1,0,67,12,55,33,19,14,307,186,121
Vendas Novas,9,9,8,1,0,0,106,22,84,86,54,32,353,194,159
Viana do Alentejo,4,4,4,0,0,0,40,8,32,11,6,5,102,55,47
Vila Viçosa,11,11,8,3,0,0,79,6,73,45,23,22,136,59,77
Algarve,850,824,779,39,14,12,2831,698,2133,16359,9094,7265,103554,54458,49096
Albufeira,81,80,76,4,0,1,216,78,138,2658,1548,1110,16405,8685,7720
Alcoutim,10,10,10,0,0,0,29,1,28,57,28,29,189,100,89
Aljezur,18,17,15,2,1,0,43,7,36,360,173,187,1985,1006,979
Castro Marim,39,39,37,2,0,0,48,6,42,162,95,67,987,536,451
Faro,64,62,57,3,1,1,369,104,265,1590,937,653,9495,5017,4478
Lagoa,42,38,38,0,3,1,144,31,113,919,515,404,5407,2801,2606
Lagos,41,40,38,2,0,1,208,45,163,2323,1247,1076,11578,5965,5613
Loulé,125,122,110,11,1,2,442,104,338,2445,1315,1130,18892,9766,9126
Monchique,43,42,41,1,1,0,40,3,37,169,93,76,889,487,402
Olhão,46,46,44,2,0,0,275,66,209,688,364,324,5079,2706,2373
Portimão,55,52,47,4,1,2,362,113,249,1731,922,809,11401,5956,5445
São Brás de Alportel,135,130,125,4,4,1,66,11,55,205,105,100,1520,742,778
Silves,50,48,44,3,1,1,233,50,183,1001,588,413,7087,3859,3228
Tavira,27,27,26,1,0,0,205,44,161,1157,672,485,7120,3905,3215
Vila do Bispo,46,43,43,0,1,2,37,11,26,429,220,209,2223,1104,1119
Vila Real de Santo António,28,28,28,0,0,0,114,24,90,465,272,193,3297,1823,1474
R. A. Açores,558,547,501,45,7,4,1539,570,969,495,254,241,4073,2062,2011
Santa Maria,13,13,13,0,0,0,32,13,19,16,8,8,139,79,60
Vila do Porto,13,13,13,0,0,0,32,13,19,16,8,8,139,79,60
São Miguel,325,319,293,26,4,2,860,361,499,239,127,112,1760,896,864
Lagoa (R.A.A.),54,54,53,1,0,0,83,25,58,25,18,7,157,90,67
Nordeste,14,13,11,2,0,1,32,5,27,5,1,4,49,25,24
Ponta Delgada,141,136,124,12,4,1,471,223,248,165,89,76,1163,593,570
Povoação,19,19,15,4,0,0,38,13,25,7,4,3,84,45,39
Ribeira Grande,64,64,61,3,0,0,168,75,93,24,9,15,221,100,121
Vila Franca do Campo,33,33,29,4,0,0,68,20,48,13,6,7,86,43,43
Terceira,126,122,109,13,2,2,362,131,231,72,32,40,616,323,293
Angra do Heroísmo,99,95,83,12,2,2,217,79,138,47,24,23,398,217,181
Vila da Praia da Vitória,27,27,26,1,0,0,145,52,93,25,8,17,218,106,112
Graciosa,10,10,9,1,0,0,28,4,24,7,3,4,46,23,23
Santa Cruz da Graciosa,10,10,9,1,0,0,28,4,24,7,3,4,46,23,23
São Jorge,16,16,13,3,0,0,62,14,48,16,7,9,114,53,61
Calheta (R.A.A.),7,7,4,3,0,0,25,5,20,8,4,4,30,19,11
Velas,9,9,9,0,0,0,37,9,28,8,3,5,84,34,50
Pico,43,42,42,0,1,0,90,24,66,52,28,24,535,265,270
Lajes do Pico,8,8,8,0,0,0,28,9,19,16,10,6,173,77,96
Madalena,27,26,26,0,1,0,41,9,32,26,12,14,227,114,113
São Roque do Pico,8,8,8,0,0,0,21,6,15,10,6,4,135,74,61
Faial,21,21,18,2,0,0,74,17,57,88,47,41,674,331,343
Horta,21,21,18,2,0,0,74,17,57,88,47,41,674,331,343
Flores,4,4,4,0,0,0,26,5,21,5,2,3,180,88,92
Lajes das Flores,3,3,3,0,0,0,14,1,13,4,1,3,113,52,61
Santa Cruz das Flores,1,1,1,0,0,0,12,4,8,1,1,0,67,36,31
Corvo,0,0,0,0,0,0,5,1,4,0,0,0,9,4,5
Corvo,0,0,0,0,0,0,5,1,4,0,0,0,9,4,5
R. A. Madeira,612,593,509,84,12,7,1519,511,1008,1418,698,720,9455,4562,4893
Calheta (R.A.M.),36,35,32,3,1,0,55,12,43,181,91,90,912,451,461
Câmara de Lobos,52,52,43,9,0,0,160,60,100,47,17,30,408,196,212
Funchal,264,251,203,48,8,5,634,199,435,708,367,341,4869,2391,2478
Machico,57,57,52,5,0,0,117,37,80,49,16,33,335,148,187
Ponta do Sol,29,27,24,3,1,1,63,17,46,82,42,40,453,204,249
Porto Moniz,8,8,7,1,0,0,25,6,19,23,8,15,104,43,61
Ribeira Brava,18,18,12,6,0,0,88,29,59,89,42,47,472,212,260
Santa Cruz,106,103,94,9,2,1,247,114,133,151,74,77,1287,625,662
Santana,13,13,13,0,0,0,54,11,43,22,10,12,112,47,65
São Vicente,9,9,9,0,0,0,43,16,27,42,21,21,160,79,81
Porto Santo,20,20,20,0,0,0,33,10,23,24,10,14,343,166,177
