,"Values paid, MF, thousand euros","Values paid, M, thousand euros","Values paid, F, thousand euros","Days subsidized , MF, No.","Days subsidized , M, No.","Days subsidized , F, No."
Portugal,1066343,490371,575972,57581312,24526923,33054389
Continente,1015829,464848,550981,54532481,23031168,31501313
Norte,375892,169090,206801,20728846,8563562,12165284
Alto Minho,16021,7377,8644,891005,383005,508000
Arcos de Valdevez,972,380,592,55255,20462,34793
Caminha,1141,515,626,64181,27455,36726
Melgaço,198,69,129,10914,3471,7443
Monção,880,355,526,50828,20027,30801
Paredes de Coura,777,348,429,46366,19488,26878
Ponte da Barca,521,256,265,30006,13805,16201
Ponte de Lima,2358,922,1436,140315,52399,87916
Valença,1231,496,736,70360,27018,43342
Viana do Castelo,7128,3649,3480,376246,177596,198650
Vila Nova de Cerveira,814,389,426,46534,21284,25250
Cávado,36408,15762,20646,1978515,786799,1191716
Amares,1438,607,831,81776,30765,51011
Barcelos,8887,4004,4883,492515,201477,291038
Braga,19743,8500,11243,1049681,418679,631002
Esposende,2601,1079,1522,140843,54921,85922
Terras de Bouro,625,266,359,39526,15319,24207
Vila Verde,3113,1306,1807,174174,65638,108536
Ave,49650,20914,28737,2766069,1066278,1699791
Cabeceiras de Basto,1204,566,638,69029,30167,38862
Fafe,6164,2503,3661,360396,135746,224650
Guimarães,21035,8521,12513,1181977,445803,736174
Mondim de Basto,380,193,187,22979,11622,11357
Póvoa de Lanhoso,1876,913,964,102801,43900,58901
Vieira do Minho,1035,595,440,58453,29630,28823
Vila Nova de Famalicão,14621,6245,8376,779488,297573,481915
Vizela,3336,1378,1958,190946,71837,119109
A. M. Porto,208446,97324,111121,11269393,4848165,6421228
Arouca,1341,594,747,77897,31488,46409
Espinho,3327,1652,1675,180276,83053,97223
Gondomar,19605,9319,10286,1086567,481441,605126
Maia,16384,7550,8834,834610,348018,486592
Matosinhos,22332,11210,11122,1152903,536913,615990
Oliveira de Azeméis,7269,3285,3983,404742,165018,239724
Paredes,8440,3421,5019,506179,183536,322643
Porto,28248,14259,13989,1486273,716325,769948
Póvoa de Varzim,7221,3535,3685,393727,175736,217991
Santa Maria da Feira,14996,6616,8380,835643,341083,494560
Santo Tirso,8381,3388,4993,478171,176428,301743
São João da Madeira,3447,1456,1992,196086,78972,117114
Trofa,4814,1988,2827,269456,100417,169039
Vale de Cambra,1634,571,1062,90569,26589,63980
Valongo,11373,5234,6139,614850,256200,358650
Vila do Conde,9968,4554,5414,533532,215493,318039
Vila Nova de Gaia,39665,18691,20975,2127912,931455,1196457
Alto Tâmega,5308,2524,2785,303661,134311,169350
Boticas,181,81,99,11220,4949,6271
Chaves,2509,1074,1435,144104,58747,85357
Montalegre,427,217,211,24568,11724,12844
Ribeira de Pena,539,301,237,30360,15345,15015
Valpaços,651,268,384,39287,15645,23642
Vila Pouca de Aguiar,1001,582,419,54122,27901,26221
Tâmega e Sousa,39918,15643,24275,2368573,832849,1535724
Amarante,5124,1766,3358,295940,92417,203523
Baião,1496,800,696,86945,41685,45260
Castelo de Paiva,1231,615,616,70260,31168,39092
Celorico de Basto,1239,496,742,73471,26141,47330
Cinfães,1674,840,834,96676,44639,52037
Felgueiras,7237,2714,4524,437619,151996,285623
Lousada,4779,1784,2995,289652,96572,193080
Marco de Canaveses,4911,1975,2936,290773,100578,190195
Paços de Ferreira,5059,1840,3218,303071,100433,202638
Penafiel,6486,2449,4037,382179,125856,256323
Resende,683,363,320,41987,21364,20623
Douro,14166,6813,7353,809206,366691,442515
Alijó,697,386,311,40137,20560,19577
Armamar,434,193,241,25331,10257,15074
Carrazeda de Ansiães,271,124,147,17001,7289,9712
Freixo de Espada à Cinta,163,71,92,9854,3597,6257
Lamego,2562,1302,1260,142752,68206,74546
Mesão Frio,241,118,123,14347,6352,7995
Moimenta da Beira,715,290,425,39918,16284,23634
Murça,361,186,175,19659,9062,10597
Penedono,107,60,47,6030,2894,3136
Peso da Régua,1175,549,626,69962,31098,38864
Sabrosa,427,174,253,25180,9141,16039
Santa Marta de Penaguião,475,278,197,28354,16316,12038
São João da Pesqueira,298,139,160,18508,7945,10563
Sernancelhe,185,71,114,12419,4237,8182
Tabuaço,357,194,163,21748,11054,10694
Tarouca,704,365,339,38072,19372,18700
Torre de Moncorvo,540,268,272,31108,13928,17180
Vila Nova de Foz Côa,417,171,246,24243,9927,14316
Vila Real,4035,1874,2161,224583,99172,125411
Terras de Trás-os-Montes,5974,2734,3240,342424,145464,196960
Alfândega da Fé,330,157,173,19051,8449,10602
Bragança,1856,857,999,105610,45340,60270
Macedo de Cavaleiros,744,360,383,41490,18343,23147
Miranda do Douro,268,112,156,14130,5246,8884
Mirandela,1484,649,835,87126,34366,52760
Mogadouro,376,212,164,21982,11648,10334
Vila Flor,419,187,232,23659,10212,13447
Vimioso,142,37,105,8012,2161,5851
Vinhais,356,163,193,21364,9699,11665
Centro,180500,80666,99834,9761125,3935439,5825686
Oeste,34597,15099,19499,1850547,718663,1131884
Alcobaça,4017,1654,2364,219531,79895,139636
Alenquer,6217,2842,3375,325694,134486,191208
Arruda dos Vinhos,1551,752,799,74253,31824,42429
Bombarral,1108,497,611,63939,25538,38401
Cadaval,1146,406,739,63534,19777,43757
Caldas da Rainha,4657,1982,2674,248147,94440,153707
Lourinhã,2035,878,1157,111761,41115,70646
Nazaré,1543,662,881,86250,33047,53203
Óbidos,921,384,537,50578,18273,32305
Peniche,3592,1573,2019,193965,72451,121514
Sobral de Monte Agraço,916,429,487,47040,19659,27381
Torres Vedras,6895,3040,3855,365855,148158,217697
Região de Aveiro,31464,14563,16901,1655710,684414,971296
Águeda,3079,1297,1782,168263,66338,101925
Albergaria-a-Velha,1852,810,1042,97339,37067,60272
Anadia,1855,808,1046,97032,39684,57348
Aveiro,7766,3794,3972,391364,172762,218602
Estarreja,2428,1211,1217,123221,51666,71555
Ílhavo,3728,1796,1932,197223,84759,112464
Murtosa,929,488,441,47451,21021,26430
Oliveira do Bairro,1437,600,837,79580,29474,50106
Ovar,6393,2931,3462,344830,142483,202347
Sever do Vouga,525,250,275,27365,11601,15764
Vagos,1472,577,894,82042,27559,54483
Região de Coimbra,33487,16318,17169,1759914,780394,979520
Arganil,726,373,353,40906,19743,21163
Cantanhede,2528,1054,1474,135693,50278,85415
Coimbra,11623,5904,5719,587774,277228,310546
Condeixa-a-Nova,1207,515,693,64077,24597,39480
Figueira da Foz,5921,3158,2762,298818,140569,158249
Góis,186,105,81,10200,5301,4899
Lousã,1222,558,663,68347,28184,40163
Mealhada,1566,727,839,78994,33299,45695
Mira,824,345,480,45129,17204,27925
Miranda do Corvo,719,404,315,39524,20959,18565
Montemor-o-Velho,1823,676,1147,98148,32197,65951
Mortágua,422,218,204,23879,11409,12470
Oliveira do Hospital,1535,749,787,89198,40682,48516
Pampilhosa da Serra,123,71,51,7618,4421,3197
Penacova,628,373,255,33539,18097,15442
Penela,226,92,134,12975,5086,7889
Soure,1044,508,536,55368,23602,31766
Tábua,678,282,396,42239,16937,25302
Vila Nova de Poiares,486,207,280,27488,10601,16887
Região de Leiria,22632,9315,13317,1208516,438611,769905
Alvaiázere,201,108,93,11900,5982,5918
Ansião,705,307,398,40712,16128,24584
Batalha,1034,389,645,54917,18732,36185
Castanheira de Pêra,141,73,68,8635,4014,4621
Figueiró dos Vinhos,251,116,135,13914,5616,8298
Leiria,10467,4326,6142,552153,198023,354130
Marinha Grande,5317,2213,3104,283747,105033,178714
Pedrógão Grande,181,114,67,10254,5762,4492
Pombal,2722,1055,1667,144337,50366,93971
Porto de Mós,1613,615,998,87947,28955,58992
Viseu Dão Lafões,21370,9166,12204,1212071,474588,737483
Aguiar da Beira,265,132,133,14956,7019,7937
Carregal do Sal,585,230,355,35397,12734,22663
Castro Daire,1284,660,623,72882,34125,38757
Mangualde,1845,717,1128,107521,37445,70076
Nelas,1263,609,654,68094,27821,40273
Oliveira de Frades,867,396,471,50844,21623,29221
Penalva do Castelo,615,239,376,35219,12893,22326
Santa Comba Dão,932,433,499,51082,21070,30012
São Pedro do Sul,1254,480,774,77934,27213,50721
Sátão,923,410,513,54422,22723,31699
Tondela,1937,696,1240,106405,35078,71327
Vila Nova de Paiva,367,201,166,22169,11624,10545
Viseu,8309,3718,4591,461313,189686,271627
Vouzela,925,244,681,53833,13534,40299
Beira Baixa,6686,2712,3973,381871,143733,238138
Castelo Branco,5231,2033,3198,295362,105413,189949
Idanha-a-Nova,534,269,265,31864,15069,16795
Oleiros,126,47,79,7151,3267,3884
Penamacor,232,114,118,14215,6694,7521
Proença-a-Nova,367,181,186,21589,9812,11777
Vila Velha de Ródão,196,68,128,11690,3478,8212
Médio Tejo,16296,7436,8859,900340,373463,526877
Abrantes,3784,1841,1943,210956,93358,117598
Alcanena,1008,465,543,56085,24565,31520
Constância,295,164,130,14763,6929,7834
Entroncamento,1602,662,940,87659,31731,55928
Ferreira do Zêzere,287,103,184,16271,5338,10933
Mação,319,153,166,18772,9012,9760
Ourém,2494,951,1543,133530,44800,88730
Sardoal,381,156,225,21279,8382,12897
Sertã,757,292,465,41918,14054,27864
Tomar,2270,1213,1058,125896,61039,64857
Torres Novas,2501,1137,1363,139692,59204,80488
Vila de Rei,198,111,87,11238,5740,5498
Vila Nova da Barquinha,402,189,213,22281,9311,12970
Beiras e Serra da Estrela,13969,6057,7913,792156,321573,470583
Almeida,317,138,178,17504,6777,10727
Belmonte,606,215,392,35422,11343,24079
Celorico da Beira,610,259,351,32424,12999,19425
Covilhã,3424,1509,1915,199032,82182,116850
Figueira de Castelo Rodrigo,257,114,144,15612,6405,9207
Fornos de Algodres,257,111,146,14699,5327,9372
Fundão,1916,875,1041,106905,42776,64129
Gouveia,735,372,364,39325,19135,20190
Guarda,3075,1270,1805,171216,67821,103395
Manteigas,169,105,64,9697,5586,4111
Mêda,133,56,77,7943,3299,4644
Pinhel,373,152,221,22117,8176,13941
Sabugal,496,200,296,28762,11053,17709
Seia,1277,541,736,72399,30619,41780
Trancoso,323,140,183,19099,8075,11024
A. M. Lisboa,334749,157238,177511,16939319,7450781,9488538
Alcochete,2393,1098,1294,115993,49608,66385
Almada,20369,9212,11157,1060896,449703,611193
Amadora,18718,8605,10113,981922,425926,555996
Barreiro,10180,4918,5262,531486,238663,292823
Cascais,24466,11052,13414,1150026,492810,657216
Lisboa,60184,29739,30445,2905215,1417763,1487452
Loures,24269,11806,12463,1266597,568398,698199
Mafra,8063,3646,4417,391803,164641,227162
Moita,8982,4371,4611,492328,216805,275523
Montijo,7264,3509,3755,384843,177279,207564
Odivelas,16055,7664,8391,862129,387104,475025
Oeiras,19719,8944,10775,881137,377874,503263
Palmela,8823,4213,4610,446539,188701,257838
Seixal,18195,8210,9986,945258,389551,555707
Sesimbra,6308,3232,3076,316844,143986,172858
Setúbal,17045,8507,8538,880933,397855,483078
Sintra,45504,19892,25612,2405120,970656,1434464
Vila Franca de Xira,18212,8620,9592,920250,393458,526792
Alentejo,68225,32497,35729,3801668,1673412,2128256
Alentejo Litoral,12991,7998,4994,708045,412679,295366
Alcácer do Sal,759,313,447,42510,15078,27432
Grândola,788,385,403,42721,18454,24267
Odemira,6194,4106,2088,362265,237679,124586
Santiago do Cacém,3055,1769,1286,153615,80639,72976
Sines,2195,1424,771,106934,60829,46105
Baixo Alentejo,9450,4288,5162,550590,234136,316454
Aljustrel,618,225,393,35732,11739,23993
Almodôvar,628,295,333,34422,14255,20167
Alvito,199,105,95,11048,5825,5223
Barrancos,192,83,108,11906,5558,6348
Beja,2227,1024,1203,125927,53462,72465
Castro Verde,495,225,269,26223,10783,15440
Cuba,301,127,174,19123,7685,11438
Ferreira do Alentejo,761,328,433,43653,17038,26615
Mértola,576,310,267,33915,17953,15962
Moura,1131,582,549,70230,34513,35717
Ourique,457,188,269,27815,10531,17284
Serpa,1335,534,801,79403,30330,49073
Vidigueira,531,264,267,31193,14464,16729
Lezíria do Tejo,24082,10829,13253,1320455,536640,783815
Almeirim,2310,938,1373,133277,48553,84724
Alpiarça,752,311,440,41436,14392,27044
Azambuja,2666,1282,1384,141834,61632,80202
Benavente,3724,1706,2019,195946,80331,115615
Cartaxo,2822,1408,1414,152705,69892,82813
Chamusca,645,223,423,36345,11936,24409
Coruche,1651,658,993,95911,34442,61469
Golegã,413,164,249,24358,8891,15467
Rio Maior,1806,815,990,101337,42024,59313
Salvaterra de Magos,2618,1031,1586,145842,50943,94899
Santarém,4674,2292,2382,251464,113604,137860
Alto Alentejo,9898,4309,5589,576278,238834,337444
Alter do Chão,252,127,126,14540,7492,7048
Arronches,177,66,111,9542,3460,6082
Avis,324,108,216,20190,6067,14123
Campo Maior,1109,500,609,60823,25704,35119
Castelo de Vide,196,106,90,12122,6278,5844
Crato,214,71,144,12448,4128,8320
Elvas,2211,944,1266,128408,53173,75235
Fronteira,297,128,169,18619,7363,11256
Gavião,237,142,95,12980,7288,5692
Marvão,188,94,94,11312,5500,5812
Monforte,202,99,102,12262,6169,6093
Nisa,376,163,213,22492,9814,12678
Ponte de Sor,1678,742,936,99175,40967,58208
Portalegre,1971,868,1103,111763,46061,65702
Sousel,467,151,316,29602,9370,20232
Alentejo Central,11804,5073,6731,646300,251123,395177
Alandroal,322,139,183,18926,7172,11754
Arraiolos,466,194,272,24457,9363,15094
Borba,585,299,286,32538,14516,18022
Estremoz,930,379,550,49670,19153,30517
Évora,4197,1857,2340,224393,91675,132718
Montemor-o-Novo,944,407,537,50514,19583,30931
Mora,216,97,120,12152,5083,7069
Mourão,310,166,143,16753,8533,8220
Portel,625,256,369,36422,13520,22902
Redondo,647,184,463,37928,9888,28040
Reguengos de Monsaraz,931,388,543,53600,19758,33842
Vendas Novas,813,382,431,42619,17255,25364
Viana do Alentejo,319,107,212,19007,5516,13491
Vila Viçosa,498,218,281,27321,10108,17213
Algarve,56463,25357,31106,3301523,1407974,1893549
Albufeira,10142,4754,5388,608398,276371,332027
Alcoutim,122,68,54,6686,3195,3491
Aljezur,377,183,194,23469,10751,12718
Castro Marim,619,282,338,37869,16824,21045
Faro,6773,3152,3621,366692,157121,209571
Lagoa,2788,1165,1624,167107,67043,100064
Lagos,3457,1506,1951,209021,87144,121877
Loulé,8108,3580,4528,461466,191334,270132
Monchique,320,148,173,19513,8817,10696
Olhão,4043,1810,2233,232371,96607,135764
Portimão,8822,4008,4814,530383,228208,302175
São Brás de Alportel,812,294,518,43961,16192,27769
Silves,5171,2293,2877,305199,130651,174548
Tavira,2169,918,1251,122805,48828,73977
Vila do Bispo,556,241,315,32706,13878,18828
Vila Real de Santo António,2183,956,1227,133877,55010,78867
R. A. Açores,26383,13540,12843,1640641,832853,807788
Santa Maria,762,378,384,51258,26018,25240
Vila do Porto,762,378,384,51258,26018,25240
São Miguel,15962,8275,7685,1000080,516512,483568
Lagoa (R.A.A.),1763,1039,723,112224,66104,46120
Nordeste,1258,632,626,85331,43529,41802
Ponta Delgada,5854,2861,2993,345408,167711,177697
Povoação,1705,878,826,114193,58888,55305
Ribeira Grande,3953,2118,1835,252727,134485,118242
Vila Franca do Campo,1429,747,682,90197,45795,44402
Terceira,4921,2591,2331,289781,145120,144661
Angra do Heroísmo,3334,1747,1588,194127,97672,96455
Vila da Praia da Vitória,1587,844,743,95654,47448,48206
Graciosa,565,263,302,36905,17089,19816
Santa Cruz da Graciosa,565,263,302,36905,17089,19816
São Jorge,792,450,342,51343,30140,21203
Calheta (R.A.A.),248,165,83,16380,10944,5436
Velas,544,285,259,34963,19196,15767
Pico,1478,564,914,92816,35250,57566
Lajes do Pico,595,222,373,38685,14279,24406
Madalena,538,226,312,32512,13387,19125
São Roque do Pico,345,116,229,21619,7584,14035
Faial,1298,724,574,77914,42308,35606
Horta,1298,724,574,77914,42308,35606
Flores,580,290,289,38846,20038,18808
Lajes das Flores,309,157,152,20526,10088,10438
Santa Cruz das Flores,271,133,137,18320,9950,8370
Corvo,26,5,21,1698,378,1320
Corvo,26,5,21,1698,378,1320
R. A. Madeira,22959,11176,11784,1356864,630970,725894
Calheta (R.A.M.),709,367,341,44079,22336,21743
Câmara de Lobos,2379,1151,1229,147449,67903,79546
Funchal,10267,4821,5446,594910,268223,326687
Machico,2452,1365,1087,138601,70468,68133
Ponta do Sol,541,271,270,33965,16208,17757
Porto Moniz,182,91,91,12479,6277,6202
Ribeira Brava,942,420,523,58497,24989,33508
Santa Cruz,4103,1945,2158,231816,105104,126712
Santana,399,239,161,29022,17073,11949
São Vicente,271,145,126,18296,9656,8640
Porto Santo,714,362,352,47750,22733,25017
