,"Casamentos, Total (N.º)","Casamentos, Entre pessoas de sexo oposto, Total (N.º)","Casamentos, Entre pessoas de sexo oposto, dos quais, Só civis (N.º)","Casamentos, Entre pessoas de sexo oposto, dos quais, Católicos (N.º)","Casamentos, Entre pessoas do mesmo sexo, Masculino, Católicos (N.º)","Casamentos, Entre pessoas do mesmo sexo, Feminino, Católicos (N.º)","Casamentos dissolvidos, Entre pessoas do mesmo sexo, Total, Católicos (N.º)","Casamentos dissolvidos, Entre pessoas do mesmo sexo, por divórcio, Católicos (N.º)","Casamentos dissolvidos, Entre pessoas do mesmo sexo, por morte, Católicos (N.º)","População estrangeira a quem foi concedido título de residência, Entre pessoas do mesmo sexo, por morte, HM (N.º)","População estrangeira a quem foi concedido título de residência, Entre pessoas do mesmo sexo, por morte, H (N.º)","População estrangeira a quem foi concedido título de residência, Entre pessoas do mesmo sexo, por morte, M (N.º)","População estrangeira com estatuto de residente, Entre pessoas do mesmo sexo, por morte, HM (N.º)","População estrangeira com estatuto de residente, Entre pessoas do mesmo sexo, por morte, H (N.º)","População estrangeira com estatuto de residente, Entre pessoas do mesmo sexo, por morte, M (N.º)"
Portugal,29057,28508,20317,8097,287,262,67187,17279,49908,111311,59885,51426,698536,359727,338809
Continente,27354,26844,19105,7649,268,242,64100,16225,47875,108967,58634,50333,683669,352363,331306
Norte,11361,11227,7040,4155,75,59,22004,6277,15727,19993,10463,9530,100084,49151,50933
Alto Minho,711,704,451,253,2,5,1628,367,1261,1743,929,814,7505,3923,3582
Arcos de Valdevez,43,43,34,9,0,0,161,24,137,69,29,40,344,150,194
Caminha,53,53,37,16,0,0,112,23,89,132,81,51,625,342,283
Melgaço,14,14,12,2,0,0,81,8,73,39,16,23,149,61,88
Monção,37,37,29,8,0,0,126,24,102,178,90,88,876,442,434
Paredes de Coura,12,12,9,3,0,0,62,8,54,46,20,26,184,93,91
Ponte da Barca,39,39,34,5,0,0,92,21,71,21,14,7,142,78,64
Ponte de Lima,141,140,68,72,0,1,249,62,187,129,70,59,548,297,251
Valença,27,27,20,7,0,0,104,29,75,256,140,116,1057,555,502
Viana do Castelo,314,308,184,124,2,4,570,152,418,724,372,352,2991,1541,1450
Vila Nova de Cerveira,31,31,24,7,0,0,71,16,55,149,97,52,589,364,225
Cávado,1525,1508,937,569,7,10,2163,690,1473,3237,1672,1565,16781,8243,8538
Amares,92,92,52,40,0,0,97,23,74,68,29,39,425,207,218
Barcelos,394,389,192,195,1,4,620,179,441,352,189,163,1704,871,833
Braga,658,650,448,202,4,4,958,354,604,2348,1174,1174,12718,6137,6581
Esposende,116,115,58,57,1,0,188,55,133,296,192,104,1093,611,482
Terras de Bouro,28,28,28,0,0,0,40,7,33,10,2,8,81,33,48
Vila Verde,237,234,159,75,1,2,260,72,188,163,86,77,760,384,376
Ave,1098,1088,685,403,6,4,2385,762,1623,1275,703,572,6803,3468,3335
Cabeceiras de Basto,49,49,26,23,0,0,103,33,70,23,15,8,164,93,71
Fafe,145,143,81,62,1,1,267,78,189,92,43,49,459,212,247
Guimarães,343,340,249,91,2,1,891,304,587,482,246,236,2686,1321,1365
Mondim de Basto,30,30,19,11,0,0,35,11,24,5,2,3,69,32,37
Póvoa de Lanhoso,46,45,45,0,0,1,153,47,106,47,29,18,337,186,151
Vieira do Minho,41,41,23,18,0,0,88,19,69,22,10,12,146,62,84
Vila Nova de Famalicão,381,378,199,179,3,0,741,236,505,549,330,219,2678,1432,1246
Vizela,63,62,43,19,0,1,107,34,73,55,28,27,264,130,134
A. M. Porto,5492,5405,3654,1725,51,36,10598,3206,7392,11339,5863,5476,57970,28176,29794
Arouca,66,66,38,28,0,0,132,41,91,7,4,3,126,68,58
Espinho,192,191,147,43,0,1,211,56,155,96,40,56,857,381,476
Gondomar,293,290,184,103,2,1,1076,304,772,499,228,271,3239,1522,1717
Maia,276,274,243,28,1,1,736,240,496,592,313,279,3796,1802,1994
Matosinhos,356,348,226,120,5,3,1037,324,713,1031,503,528,6311,2988,3323
Oliveira de Azeméis,160,160,82,78,0,0,432,123,309,171,89,82,1094,515,579
Paredes,170,170,66,104,0,0,470,182,288,212,107,105,961,457,504
Porto,1372,1326,1002,317,27,19,1488,401,1087,4803,2562,2241,18936,9576,9360
Póvoa de Varzim,339,333,231,101,6,0,377,122,255,490,250,240,2550,1255,1295
Santa Maria da Feira,380,376,211,163,2,2,823,245,578,345,164,181,2081,929,1152
Santo Tirso,237,236,117,116,1,0,473,123,350,94,41,53,647,281,366
São João da Madeira,121,119,85,33,1,1,148,47,101,224,115,109,1024,497,527
Trofa,134,133,59,74,1,0,230,69,161,171,113,58,776,430,346
Vale de Cambra,97,97,66,31,0,0,151,34,117,104,54,50,460,243,217
Valongo,344,342,235,107,2,0,512,184,328,292,136,156,1774,839,935
Vila do Conde,326,324,224,98,0,2,533,168,365,478,292,186,2834,1530,1304
Vila Nova de Gaia,629,620,438,181,3,6,1769,543,1226,1730,852,878,10504,4863,5641
Alto Tâmega,227,224,160,64,1,2,676,148,528,212,111,101,1398,688,710
Boticas,13,13,11,2,0,0,41,9,32,7,4,3,56,28,28
Chaves,120,117,80,37,1,2,287,86,201,119,56,63,728,320,408
Montalegre,26,26,19,7,0,0,79,11,68,14,7,7,100,48,52
Ribeira de Pena,10,10,7,3,0,0,33,4,29,21,17,4,118,85,33
Valpaços,33,33,26,7,0,0,137,18,119,26,8,18,188,74,114
Vila Pouca de Aguiar,25,25,17,8,0,0,99,20,79,25,19,6,208,133,75
Tâmega e Sousa,1544,1536,711,822,8,0,2290,665,1625,758,468,290,3528,1768,1760
Amarante,259,257,127,130,2,0,291,84,207,98,64,34,485,228,257
Baião,53,53,21,32,0,0,113,30,83,30,20,10,124,70,54
Castelo de Paiva,56,56,36,20,0,0,95,18,77,35,25,10,115,64,51
Celorico de Basto,62,62,33,29,0,0,126,24,102,15,6,9,100,43,57
Cinfães,35,35,16,19,0,0,126,30,96,41,37,4,126,80,46
Felgueiras,204,202,69,133,2,0,278,90,188,103,58,45,448,213,235
Lousada,196,196,62,133,0,0,252,88,164,139,103,36,513,313,200
Marco de Canaveses,212,210,110,99,2,0,262,81,181,99,54,45,504,235,269
Paços de Ferreira,164,163,67,96,1,0,311,107,204,84,43,41,434,195,239
Penafiel,266,266,148,117,0,0,370,100,270,109,57,52,623,297,326
Resende,37,36,22,14,1,0,66,13,53,5,1,4,56,30,26
Douro,536,535,294,240,0,1,1409,314,1095,395,219,176,2559,1256,1303
Alijó,26,26,14,12,0,0,103,18,85,10,3,7,93,40,53
Armamar,15,15,10,5,0,0,44,5,39,21,15,6,77,42,35
Carrazeda de Ansiães,14,14,8,6,0,0,58,9,49,20,9,11,136,75,61
Freixo de Espada à Cinta,4,4,3,1,0,0,31,2,29,5,1,4,98,50,48
Lamego,74,74,42,32,0,0,173,40,133,20,18,2,150,69,81
Mesão Frio,22,22,19,3,0,0,31,7,24,4,2,2,17,6,11
Moimenta da Beira,22,22,14,8,0,0,62,13,49,23,12,11,151,77,74
Murça,16,16,5,11,0,0,41,8,33,4,0,4,46,15,31
Penedono,15,15,9,6,0,0,20,3,17,0,0,0,19,9,10
Peso da Régua,70,70,47,23,0,0,124,25,99,5,3,2,100,47,53
Sabrosa,11,11,5,6,0,0,47,11,36,4,2,2,37,16,21
Santa Marta de Penaguião,18,18,9,9,0,0,58,10,48,3,2,1,69,44,25
São João da Pesqueira,8,8,5,3,0,0,46,5,41,12,6,6,86,40,46
Sernancelhe,19,19,9,10,0,0,39,9,30,13,9,4,62,39,23
Tabuaço,15,15,5,10,0,0,33,5,28,11,7,4,45,24,21
Tarouca,15,15,6,9,0,0,61,21,40,7,2,5,65,30,35
Torre de Moncorvo,10,10,10,0,0,0,57,6,51,7,3,4,82,30,52
Vila Nova de Foz Côa,15,15,9,6,0,0,68,10,58,10,7,3,185,98,87
Vila Real,147,146,65,80,0,1,313,107,206,216,118,98,1041,505,536
Terras de Trás-os-Montes,228,227,148,79,0,1,855,125,730,1034,498,536,3540,1629,1911
Alfândega da Fé,5,5,4,1,0,0,58,7,51,16,12,4,164,86,78
Bragança,82,81,54,27,0,1,205,32,173,747,364,383,2059,944,1115
Macedo de Cavaleiros,31,31,18,13,0,0,129,27,102,46,24,22,254,121,133
Miranda do Douro,8,8,6,2,0,0,50,1,49,21,4,17,109,44,65
Mirandela,52,52,36,16,0,0,167,28,139,145,59,86,537,236,301
Mogadouro,20,20,13,7,0,0,81,13,68,19,12,7,92,45,47
Vila Flor,9,9,3,6,0,0,62,11,51,6,3,3,199,97,102
Vimioso,9,9,7,2,0,0,31,2,29,25,14,11,74,36,38
Vinhais,12,12,7,5,0,0,72,4,68,9,6,3,52,20,32
Centro,6064,6002,4044,1938,30,32,16185,3513,12672,16106,8367,7739,94751,48041,46710
Oeste,1217,1197,891,300,9,11,2496,550,1946,3908,2129,1779,23487,12313,11174
Alcobaça,156,153,101,51,1,2,415,91,324,474,249,225,2814,1463,1351
Alenquer,205,202,167,35,2,1,277,70,207,514,255,259,3418,1717,1701
Arruda dos Vinhos,81,81,61,19,0,0,96,27,69,124,57,67,778,403,375
Bombarral,50,50,44,6,0,0,104,13,91,96,55,41,617,321,296
Cadaval,33,33,24,9,0,0,111,17,94,56,35,21,473,244,229
Caldas da Rainha,95,94,70,24,0,1,343,74,269,597,315,282,3998,2041,1957
Lourinhã,55,55,45,8,0,0,158,29,129,277,150,127,1705,886,819
Nazaré,117,115,96,19,0,2,111,26,85,259,139,120,1146,585,561
Óbidos,46,46,28,18,0,0,96,22,74,148,87,61,961,495,466
Peniche,87,84,59,25,0,3,172,30,142,305,159,146,1578,803,775
Sobral de Monte Agraço,56,54,37,17,2,0,73,20,53,73,36,37,424,220,204
Torres Vedras,236,230,159,69,4,2,540,131,409,985,592,393,5575,3135,2440
Região de Aveiro,1135,1121,794,324,11,3,2446,614,1832,2401,1202,1199,14213,6958,7255
Águeda,106,106,76,30,0,0,306,72,234,293,154,139,1598,836,762
Albergaria-a-Velha,76,74,55,19,1,1,193,44,149,113,52,61,642,319,323
Anadia,55,53,28,25,1,1,189,40,149,94,47,47,754,358,396
Aveiro,272,267,200,66,5,0,495,144,351,1117,551,566,5829,2819,3010
Estarreja,90,90,67,22,0,0,183,31,152,66,32,34,651,333,318
Ílhavo,82,82,49,33,0,0,254,65,189,242,115,127,1486,683,803
Murtosa,81,80,66,14,1,0,78,22,56,40,20,20,232,116,116
Oliveira do Bairro,110,109,73,36,0,1,166,47,119,127,62,65,1016,483,533
Ovar,130,129,90,39,1,0,338,110,228,151,80,71,1097,558,539
Sever do Vouga,17,17,15,1,0,0,94,11,83,46,24,22,226,104,122
Vagos,116,114,75,39,2,0,150,28,122,112,65,47,682,349,333
Região de Coimbra,1132,1120,748,368,4,8,3233,727,2506,3124,1477,1647,18257,8904,9353
Arganil,17,16,12,4,0,1,108,13,95,69,34,35,741,388,353
Cantanhede,100,100,59,40,0,0,262,49,213,132,78,54,777,380,397
Coimbra,410,406,244,161,2,2,914,254,660,1809,770,1039,7995,3644,4351
Condeixa-a-Nova,33,33,22,11,0,0,100,28,72,33,16,17,382,171,211
Figueira da Foz,179,175,146,28,0,4,439,113,326,441,233,208,2983,1514,1469
Góis,7,7,7,0,0,0,43,4,39,10,5,5,289,162,127
Lousã,25,24,16,8,1,0,103,29,74,44,18,26,536,263,273
Mealhada,37,37,23,14,0,0,143,27,116,55,24,31,404,203,201
Mira,34,34,19,15,0,0,112,17,95,48,22,26,307,149,158
Miranda do Corvo,15,15,7,8,0,0,104,25,79,37,18,19,393,197,196
Montemor-o-Velho,77,76,49,27,1,0,174,34,140,60,34,26,329,175,154
Mortágua,17,17,14,3,0,0,69,8,61,60,36,24,306,170,136
Oliveira do Hospital,24,24,17,7,0,0,161,29,132,121,72,49,866,475,391
Pampilhosa da Serra,7,7,5,2,0,0,38,5,33,2,1,1,36,16,20
Penacova,40,39,25,14,0,1,127,26,101,33,19,14,208,101,107
Penela,36,36,33,3,0,0,48,9,39,42,24,18,397,224,173
Soure,40,40,27,12,0,0,142,35,107,34,17,17,291,133,158
Tábua,16,16,13,3,0,0,104,15,89,59,37,22,688,361,327
Vila Nova de Poiares,18,18,10,8,0,0,42,7,35,35,19,16,329,178,151
Região de Leiria,693,690,454,231,1,2,1879,417,1462,2405,1290,1115,15837,8153,7684
Alvaiázere,10,10,6,4,0,0,56,5,51,13,10,3,495,265,230
Ansião,26,26,15,11,0,0,104,15,89,35,20,15,387,205,182
Batalha,77,77,37,40,0,0,102,20,82,81,48,33,647,332,315
Castanheira de Pêra,4,3,3,0,0,1,23,4,19,12,6,6,139,73,66
Figueiró dos Vinhos,10,10,7,3,0,0,52,5,47,12,8,4,288,150,138
Leiria,300,298,196,99,1,1,748,201,547,1313,666,647,7501,3694,3807
Marinha Grande,77,77,66,10,0,0,234,62,172,454,272,182,2845,1519,1326
Pedrógão Grande,12,12,6,6,0,0,32,2,30,82,38,44,622,325,297
Pombal,144,144,97,46,0,0,390,67,323,288,158,130,2027,1135,892
Porto de Mós,33,33,21,12,0,0,138,36,102,115,64,51,886,455,431
Viseu Dão Lafões,699,696,414,282,1,2,1926,412,1514,1197,644,553,6186,3148,3038
Aguiar da Beira,18,18,8,10,0,0,61,5,56,3,2,1,45,25,20
Carregal do Sal,18,18,13,5,0,0,71,13,58,44,26,18,210,102,108
Castro Daire,43,43,21,22,0,0,108,19,89,18,8,10,164,80,84
Mangualde,80,79,46,33,0,1,150,26,124,44,20,24,404,229,175
Nelas,44,44,29,15,0,0,99,17,82,28,14,14,272,134,138
Oliveira de Frades,34,34,21,13,0,0,58,16,42,88,55,33,404,248,156
Penalva do Castelo,20,20,7,13,0,0,68,7,61,8,7,1,67,35,32
Santa Comba Dão,26,26,15,11,0,0,95,23,72,54,37,17,298,171,127
São Pedro do Sul,33,32,27,5,0,1,140,28,112,65,43,22,272,136,136
Sátão,29,29,18,11,0,0,72,9,63,22,11,11,109,54,55
Tondela,60,60,41,19,0,0,212,33,179,106,63,43,429,241,188
Vila Nova de Paiva,15,15,11,4,0,0,38,8,30,3,1,2,57,23,34
Viseu,255,254,143,111,1,0,673,193,480,688,344,344,3321,1605,1716
Vouzela,24,24,14,10,0,0,81,15,66,26,13,13,134,65,69
Beira Baixa,186,184,118,65,1,1,664,107,557,659,369,290,3562,1902,1660
Castelo Branco,142,140,91,48,1,1,414,85,329,443,236,207,2122,1083,1039
Idanha-a-Nova,11,11,9,2,0,0,71,9,62,88,56,32,475,265,210
Oleiros,12,12,9,3,0,0,35,5,30,33,21,12,156,95,61
Penamacor,5,5,1,4,0,0,51,2,49,35,18,17,398,204,194
Proença-a-Nova,14,14,7,7,0,0,67,4,63,32,20,12,228,129,99
Vila Velha de Ródão,2,2,1,1,0,0,26,2,24,28,18,10,183,126,57
Médio Tejo,582,580,370,209,0,2,1794,384,1410,1313,653,660,7960,3946,4014
Abrantes,71,71,47,24,0,0,282,53,229,66,31,35,608,303,305
Alcanena,16,16,9,7,0,0,95,18,77,55,27,28,443,211,232
Constância,36,36,28,8,0,0,33,5,28,2,1,1,48,16,32
Entroncamento,30,30,25,5,0,0,127,36,91,210,93,117,984,448,536
Ferreira do Zêzere,25,25,19,6,0,0,66,9,57,46,25,21,387,199,188
Mação,9,9,5,4,0,0,64,7,57,21,9,12,146,64,82
Ourém,159,158,89,69,0,1,322,76,246,531,267,264,2684,1353,1331
Sardoal,9,9,5,4,0,0,28,8,20,6,2,4,68,40,28
Sertã,37,37,33,4,0,0,108,21,87,98,61,37,560,311,249
Tomar,88,87,54,33,0,1,296,75,221,148,64,84,1151,562,589
Torres Novas,49,49,24,25,0,0,295,69,226,102,57,45,684,343,341
Vila de Rei,9,9,5,4,0,0,26,2,24,12,9,3,90,49,41
Vila Nova da Barquinha,44,44,27,16,0,0,52,5,47,16,7,9,107,47,60
Beiras e Serra da Estrela,420,414,255,159,3,3,1747,302,1445,1099,603,496,5249,2717,2532
Almeida,11,11,5,6,0,0,65,5,60,15,8,7,105,43,62
Belmonte,10,10,4,6,0,0,36,9,27,22,14,8,91,50,41
Celorico da Beira,20,20,18,2,0,0,67,14,53,22,12,10,160,79,81
Covilhã,80,76,57,19,2,2,374,95,279,376,198,178,1497,791,706
Figueira de Castelo Rodrigo,5,5,4,1,0,0,47,9,38,7,4,3,43,19,24
Fornos de Algodres,7,7,4,3,0,0,44,1,43,8,6,2,77,41,36
Fundão,61,61,32,29,0,0,199,30,169,181,99,82,1206,648,558
Gouveia,25,25,20,5,0,0,98,12,86,24,14,10,225,113,112
Guarda,104,103,48,55,1,0,295,68,227,323,182,141,973,504,469
Manteigas,5,5,4,1,0,0,27,7,20,17,9,8,40,18,22
Mêda,12,11,5,6,0,1,45,5,40,3,3,0,42,24,18
Pinhel,15,15,10,5,0,0,81,13,68,9,7,2,84,45,39
Sabugal,10,10,4,6,0,0,102,7,95,13,8,5,131,61,70
Seia,44,44,33,11,0,0,198,23,175,61,25,36,475,227,248
Trancoso,11,11,7,4,0,0,69,4,65,18,14,4,100,54,46
A. M. Lisboa,6816,6561,5584,948,129,126,17456,4649,12807,54283,28862,25421,343995,176104,167891
Alcochete,81,77,62,15,1,3,111,45,66,192,96,96,1388,719,669
Almada,211,207,186,21,2,2,1090,271,819,2739,1380,1359,16570,8227,8343
Amadora,104,102,76,25,0,2,1012,285,727,3239,1735,1504,23834,12075,11759
Barreiro,207,201,178,23,3,3,591,129,462,997,491,506,5768,2781,2987
Cascais,551,526,427,99,14,11,1287,387,900,4937,2470,2467,34097,16578,17519
Lisboa,2218,2108,1734,363,67,43,3340,732,2608,18664,10386,8278,108653,59183,49470
Loures,342,336,254,74,4,2,1260,291,969,3337,1781,1556,21579,10942,10637
Mafra,277,275,200,75,1,1,452,153,299,1121,585,536,6116,3013,3103
Moita,132,131,116,15,0,1,469,122,347,782,386,396,4460,2117,2343
Montijo,133,130,113,16,1,2,365,91,274,903,553,350,5848,3262,2586
Odivelas,x,x,x,x,x,x,908,230,678,3267,1863,1404,20788,11035,9753
Oeiras,417,403,378,25,8,6,974,248,726,2086,1036,1050,14070,6681,7389
Palmela,182,180,151,29,2,0,456,127,329,550,297,253,3469,1743,1726
Seixal,269,261,229,28,2,6,1059,321,738,2206,1099,1107,12904,6255,6649
Sesimbra,307,299,281,18,2,6,298,87,211,510,248,262,3290,1627,1663
Setúbal,460,444,426,17,8,8,930,234,696,1535,801,734,9509,4810,4699
Sintra,726,687,615,70,13,26,2060,657,1403,6077,3099,2978,42475,20583,21892
Vila Franca de Xira,199,194,158,35,1,4,794,239,555,1141,556,585,9177,4473,4704
Alentejo,1874,1849,1375,468,14,11,5442,1012,4430,6592,4322,2270,39702,23378,16324
Alentejo Litoral,220,217,191,24,1,2,637,94,543,2512,1834,678,14622,9482,5140
Alcácer do Sal,23,22,17,5,1,0,97,6,91,78,47,31,492,283,209
Grândola,44,44,35,7,0,0,100,18,82,153,89,64,765,389,376
Odemira,30,30,27,3,0,0,159,18,141,1895,1471,424,10927,7505,3422
Santiago do Cacém,62,61,55,6,0,1,193,33,160,204,114,90,1348,722,626
Sines,61,60,57,3,0,1,88,19,69,182,113,69,1090,583,507
Baixo Alentejo,282,279,229,49,2,1,934,149,785,975,740,235,5026,3135,1891
Aljustrel,9,9,8,1,0,0,70,8,62,32,23,9,178,112,66
Almodôvar,11,11,7,4,0,0,57,6,51,36,26,10,247,130,117
Alvito,12,12,8,4,0,0,29,5,24,12,7,5,82,39,43
Barrancos,4,4,3,1,0,0,13,2,11,3,2,1,18,10,8
Beja,94,92,75,16,1,1,225,46,179,370,259,111,1808,1107,701
Castro Verde,14,14,14,0,0,0,47,7,40,25,16,9,201,110,91
Cuba,5,5,4,1,0,0,45,8,37,154,148,6,451,368,83
Ferreira do Alentejo,32,31,30,1,1,0,83,18,65,150,132,18,692,513,179
Mértola,21,21,19,2,0,0,60,3,57,24,13,11,181,89,92
Moura,30,30,23,7,0,0,103,16,87,9,3,6,249,141,108
Ourique,18,18,15,3,0,0,36,7,29,50,21,29,383,181,202
Serpa,23,23,19,4,0,0,118,16,102,100,85,15,386,252,134
Vidigueira,9,9,4,5,0,0,48,7,41,10,5,5,150,83,67
Lezíria do Tejo,664,651,481,170,7,6,1812,414,1398,1945,1148,797,12276,6798,5478
Almeirim,49,48,40,8,1,0,174,41,133,180,100,80,1000,551,449
Alpiarça,24,24,19,5,0,0,59,14,45,36,23,13,339,194,145
Azambuja,48,48,32,16,0,0,153,31,122,217,110,107,1333,679,654
Benavente,89,86,79,7,2,1,189,56,133,236,120,116,2278,1153,1125
Cartaxo,53,51,41,10,1,1,161,42,119,166,103,63,978,522,456
Chamusca,5,4,1,3,1,0,74,8,66,23,15,8,118,64,54
Coruche,19,19,8,11,0,0,166,28,138,36,26,10,350,194,156
Golegã,40,39,26,13,0,1,54,9,45,19,16,3,100,57,43
Rio Maior,40,40,33,7,0,0,145,39,106,306,185,121,1786,1128,658
Salvaterra de Magos,76,76,63,13,0,0,175,34,141,86,54,32,589,303,286
Santarém,221,216,139,77,2,3,462,112,350,640,396,244,3405,1953,1452
Alto Alentejo,204,203,137,65,1,0,926,150,776,405,196,209,2881,1416,1465
Alter do Chão,9,9,7,2,0,0,31,5,26,8,2,6,114,55,59
Arronches,6,6,6,0,0,0,28,2,26,14,7,7,70,37,33
Avis,8,8,3,5,0,0,34,4,30,8,4,4,61,34,27
Campo Maior,13,13,9,4,0,0,54,10,44,23,9,14,262,123,139
Castelo de Vide,5,5,5,0,0,0,31,5,26,26,13,13,142,68,74
Crato,8,8,4,4,0,0,43,4,39,4,3,1,66,30,36
Elvas,50,50,33,17,0,0,172,33,139,81,38,43,624,275,349
Fronteira,4,4,3,1,0,0,22,3,19,5,3,2,71,39,32
Gavião,10,10,8,2,0,0,28,1,27,4,2,2,18,11,7
Marvão,5,5,2,3,0,0,39,8,31,43,21,22,212,110,102
Monforte,6,6,4,2,0,0,20,1,19,2,1,1,36,23,13
Nisa,9,9,4,5,0,0,76,8,68,14,6,8,92,46,46
Ponte de Sor,20,20,13,6,0,0,123,21,102,43,26,17,395,212,183
Portalegre,42,41,27,14,1,0,172,37,135,110,52,58,619,300,319
Sousel,9,9,9,0,0,0,53,8,45,20,9,11,99,53,46
Alentejo Central,504,499,337,160,3,2,1133,205,928,755,404,351,4897,2547,2350
Alandroal,17,17,15,2,0,0,43,5,38,11,7,4,119,72,47
Arraiolos,15,15,7,8,0,0,52,10,42,13,7,6,164,86,78
Borba,14,14,4,10,0,0,59,10,49,7,3,4,129,52,77
Estremoz,38,37,23,14,0,1,101,14,87,16,7,9,326,159,167
Évora,205,203,136,66,2,0,341,89,252,431,219,212,2282,1147,1135
Montemor-o-Novo,43,43,35,8,0,0,136,16,120,75,41,34,452,235,217
Mora,15,15,12,3,0,0,42,3,39,5,3,2,47,25,22
Mourão,16,16,12,4,0,0,17,3,14,9,4,5,51,31,20
Portel,12,12,8,4,0,0,32,2,30,13,11,2,129,74,55
Redondo,19,18,15,3,0,1,45,8,37,10,5,5,194,104,90
Reguengos de Monsaraz,46,45,31,13,1,0,84,12,72,30,17,13,307,184,123
Vendas Novas,20,20,16,4,0,0,80,11,69,109,64,45,451,255,196
Viana do Alentejo,13,13,8,5,0,0,50,11,39,12,8,4,108,60,48
Vila Viçosa,31,31,15,16,0,0,51,11,40,14,8,6,138,63,75
Algarve,1239,1205,1062,140,20,14,3013,774,2239,11993,6620,5373,105137,55689,49448
Albufeira,191,185,172,13,4,2,199,62,137,1913,1063,850,16433,8777,7656
Alcoutim,20,20,19,1,0,0,21,2,19,38,22,16,219,117,102
Aljezur,13,13,13,0,0,0,36,8,28,326,164,162,2192,1107,1085
Castro Marim,43,43,35,8,0,0,51,15,36,90,57,33,997,553,444
Faro,101,99,77,21,2,0,456,135,321,1342,789,553,9714,5262,4452
Lagoa,27,27,27,0,0,0,150,42,108,553,323,230,5459,2855,2604
Lagos,56,56,50,6,0,0,217,46,171,1137,591,546,11651,6021,5630
Loulé,145,143,111,32,2,0,507,126,381,1846,970,876,18707,9695,9012
Monchique,109,107,99,8,2,0,43,4,39,85,49,36,907,495,412
Olhão,50,48,40,7,0,2,268,68,200,676,358,318,5288,2808,2480
Portimão,53,52,48,4,0,1,399,126,273,1610,899,711,12014,6346,5668
São Brás de Alportel,222,212,200,11,7,3,72,17,55,124,64,60,1511,746,765
Silves,75,72,64,8,1,2,260,55,205,806,471,335,7231,3972,3259
Tavira,40,39,27,12,0,1,185,36,149,840,475,365,7238,3970,3268
Vila do Bispo,53,51,51,0,0,2,35,6,29,318,157,161,2345,1173,1172
Vila Real de Santo António,41,38,29,9,2,1,114,26,88,289,168,121,3231,1792,1439
R. A. Açores,837,828,570,254,6,3,1532,603,929,679,352,327,4462,2266,2196
Santa Maria,9,9,5,4,0,0,30,8,22,27,14,13,163,90,73
Vila do Porto,9,9,5,4,0,0,30,8,22,27,14,13,163,90,73
São Miguel,480,475,335,137,3,2,816,348,468,376,189,187,2007,1031,976
Lagoa (R.A.A.),118,118,101,16,0,0,92,31,61,20,12,8,162,92,70
Nordeste,21,20,15,5,1,0,29,10,19,11,5,6,58,30,28
Ponta Delgada,183,181,108,71,0,2,455,224,231,276,132,144,1337,681,656
Povoação,21,20,15,5,1,0,34,14,20,16,11,5,104,60,44
Ribeira Grande,86,85,60,25,1,0,161,63,98,33,19,14,248,121,127
Vila Franca do Campo,51,51,36,15,0,0,45,6,39,20,10,10,98,47,51
Terceira,207,205,127,78,2,0,338,128,210,105,46,59,671,340,331
Angra do Heroísmo,168,167,101,66,1,0,206,78,128,70,35,35,445,238,207
Vila da Praia da Vitória,39,38,26,12,1,0,132,50,82,35,11,24,226,102,124
Graciosa,13,13,9,4,0,0,30,12,18,10,6,4,52,26,26
Santa Cruz da Graciosa,13,13,9,4,0,0,30,12,18,10,6,4,52,26,26
São Jorge,18,18,13,5,0,0,60,16,44,27,14,13,134,62,72
Calheta (R.A.A.),6,6,4,2,0,0,23,6,17,7,3,4,39,22,17
Velas,12,12,9,3,0,0,37,10,27,20,11,9,95,40,55
Pico,50,50,41,9,0,0,87,30,57,43,27,16,538,273,265
Lajes do Pico,19,19,16,3,0,0,25,9,16,8,5,3,180,78,102
Madalena,20,20,14,6,0,0,37,12,25,21,11,10,221,114,107
São Roque do Pico,11,11,11,0,0,0,25,9,16,14,11,3,137,81,56
Faial,51,50,32,17,1,0,129,45,84,76,46,30,714,355,359
Horta,51,50,32,17,1,0,129,45,84,76,46,30,714,355,359
Flores,6,6,6,0,0,0,39,15,24,13,8,5,172,84,88
Lajes das Flores,4,4,4,0,0,0,20,6,14,10,7,3,117,57,60
Santa Cruz das Flores,2,2,2,0,0,0,19,9,10,3,1,2,55,27,28
Corvo,3,2,2,0,0,1,3,1,2,2,2,0,11,5,6
Corvo,3,2,2,0,0,1,3,1,2,2,2,0,11,5,6
R. A. Madeira,866,836,642,194,13,17,1555,451,1104,1665,899,766,10405,5098,5307
Calheta (R.A.M.),80,77,69,8,1,2,88,20,68,150,85,65,982,499,483
Câmara de Lobos,64,64,35,29,0,0,176,59,117,55,29,26,458,227,231
Funchal,331,317,232,85,7,7,685,189,496,869,489,380,5280,2653,2627
Machico,86,81,65,16,4,1,117,36,81,79,42,37,400,184,216
Ponta do Sol,45,41,39,2,0,4,50,14,36,80,41,39,516,234,282
Porto Moniz,19,19,18,1,0,0,14,3,11,9,3,6,105,43,62
Ribeira Brava,48,47,33,14,0,1,74,20,54,62,32,30,503,232,271
Santa Cruz,140,137,106,31,1,2,215,83,132,221,109,112,1429,676,753
Santana,19,19,15,4,0,0,48,8,40,14,7,7,117,55,62
São Vicente,7,7,6,1,0,0,52,9,43,37,19,18,195,92,103
Porto Santo,27,27,24,3,0,0,36,10,26,89,43,46,420,203,217
